The Project Gutenberg eBook of List of Post Offices in Canada, with
the names of the postmasters on the 1st January, 1863, by Postmaster
General

This eBook is for the use of anyone anywhere in the United States and
most other parts of the world at no cost and with almost no restrictions
whatsoever. You may copy it, give it away or re-use it under the terms
of the Project Gutenberg License included with this eBook or online at
www.gutenberg.org. If you are not located in the United States, you
will have to check the laws of the country where you are located before
using this eBook.

Title: List of Post Offices in Canada, with the names of the postmasters
       on the 1st January, 1863

Author: Postmaster General

Release Date: October 23, 2022 [eBook #69214]

Language: English

Produced by: WebRover, Adrian Mastronardi, The Philatelic Digital
             Library Project and the Online Distributed Proofreading
             Team at https://www.pgdp.net (This file was produced from
             images generously made available by The Internet
             Archive/Canadian Libraries)

*** START OF THE PROJECT GUTENBERG EBOOK LIST OF POST OFFICES IN
CANADA, WITH THE NAMES OF THE POSTMASTERS ON THE 1ST JANUARY, 1863 ***

Transcriber’s Note: A large number of obvious printer’s errors have been
corrected, mostly around punctuation and accents, but more or less no
attempt has been made to standardise the varying spelling of the names of
people and places.




                                  LIST
                                   OF
                              POST OFFICES
                                   IN
                                 CANADA,
                                WITH THE
                        NAMES OF THE POSTMASTERS
                                   ON
                         THE 1st JANUARY, 1863.

               Printed by Order of the Postmaster General.

                             [Illustration]

                                 QUEBEC:
                 PRINTED BY JOSIAH BLACKBURN, UPPER TOWN
                                  1863.




Principal Officers of the Post Office Department.


  HON. M. H. FOLEY,            _Postmaster General_.
  WILLIAM HENRY GRIFFIN,       _Deputy Postmaster General_.
  H. A. WICKSTEED,             _Accountant_.
  WILLIAM WHITE,               _Secretary_.
  JOHN ASHWORTH,               _Cashier_.

  PETER LESUEUR:               _Superintendent Money Order Branch_.


Inspectors.

                                                  STATION.
  JOHN DEWE       in charge of  Toronto Division  Toronto.
  G. E. GRIFFIN        ”        London     ”      London.
  M. SWEETNAM          ”        Kingston   ”      Kingston.
  E. F. KING           ”        Montreal   ”      Montreal.
  W. G. SHEPPARD       ”        Quebec     ”      Quebec.


(_Memorandum._)

                                                   POST OFFICE DEPARTMENT,
                                                        1st January, 1863.

Postmasters will correct their Lists by the Notices of Post Office
Operations, with which they will be furnished from time to time; and
should any Postmaster discover an error in the description of his Office,
as set forth in this List, he will please notify the same to this
Department.




LIST OF POST OFFICES IN CANADA, AND THE NAMES OF THE POSTMASTERS,

ON THE 1ST JANUARY, 1863.

_The Offices whose names are printed in Italics are authorised to Grant
and Pay Money Orders._


  ====================+===============+=================+=================
                      |TOWNSHIP IF IN |                 |
                      |CANADA WEST,   |                 |
                      |AND TOWNSHIP,  |                 |
                      |SEIGNIORY OR   |                 |
                      |PARISH, IF IN  |ELECTORAL COUNTY |NAME OF
  NAME OF POST OFFICE.|CANADA EAST.   |OR DIVISION.     |POSTMASTER.
  --------------------+---------------+-----------------+-----------------
  Abbott’s Corners    |               |Missisquoi       |H. H. Smith
  Abbottsford         |               |Rouville         |Ebenezer Fisk
  Abercorn            |Sutton         |Brome            |Benjamin Seaton
  Aberfoyle           |Puslinch       |Wellington, S. R.|S. Falconbridge
  Abingdon            |Caistor        |Lincoln          |Thomas Pearson
  Acton               |Esquesing      |Halton           |J. Matthews
  Acton Vale          |Acton          |Bagot            |A. Quintin dit
                      |               |                 |  Dubois
  Adamsville          |Farnham        |Brome            |George Adams
  Adare               |Biddulph       |Huron            |William Clarke
  Addison             |Elizabethtown  |T’n of Brockville|Coleman Lewis
  Adelaide            |Adelaide       |Middlesex, W. R. |John S. Hoare
  Admaston            |Admaston       |Renfrew          |Arch. Patterson
  Adolphustown        |Adolphustown   |Lenox            |J. J. Watson
  Agincourt           |Scarboro’      |York, E. R.      |John Hill
  Ailsa Craig         |West           |Huron            |Shackleton Hey
                      |  McGillivray  |                 |
  Alberton            |Ancaster       |Wentworth, S. R. |James Galloway
  _Albion_            |Albion         |Peel             |Samuel Walford
  Albury              |Ameliasburg    |Prince Edward    |Isaac Dempsey
  Aldboro’            |Aldboro’       |Elgin, W. R.     |D. McDougall
  Aldershott          |Flamboro’ E.   |Wentworth, N. R. |Alexander Brown
  Alderville          |Alnwick        |Northumberl’d,   |R. Mulholland
                      |               |  W. R.          |
  Alexandria          |Lochiel        |Glengary         |Alex. McDonell
  Alfred              |Alfred         |Prescott         |John Hill
  Algonquin           |Augusta        |Grenville, S. R. |Silas Wright
  Allanburg           |Thorold        |Welland          |John Rannie
  Allandale Mills     |Otanabee       |Peterboro’       |Richard Short
  Allan Park          |Bentinck       |Grey             |G. B. Allan
  Allan’s Corners     |Durham         |Chateauguay      |W. McArthur
  Allendale           |Innisfil       |Simcoe, S. R.    |B. Sheridan
  Allisonville        |Ameliasburg    |Prince Edward    |
  Alliston            |Tecumseth      |Simcoe, S. R.    |George Fletcher
  Allumette Island    |Allumette      |Pontiac          |John Lynch
                      |  Island       |                 |
  Alma                |Peel           |Wellington, N. R.|Thomas Graham
  Almira              |Markham        |York, E. R.      |
  _Almonte_           |Ramsay         |Lanark, N. R.    |James H. Wylie,
                      |               |                 |  Jr.
  Alton               |Caledon        |Peel             |John S. Meek
  Altona              |Pickering      |Ontario, S. R.   |Joseph Monkhouse
  Alvinston           |Brooke         |Lambton          |J. Brannan
  Ameliasburg         |Ameliasburg    |Prince Edward    |Owen Roblin
  _Amherstburg_       |Maldon         |Essex            |James Kevill
  Amiens              |Lobo           |Middlesex, W. R. |D. McArthur
  Ancaster            |Ancaster       |Wentworth, S. R. |G. B. Rousseaux
  Ancienne Lorette    |Quebec         |Quebec           |Michel Gauvin
  Ange Gardien        |Ange Gardien   |Montmorency      |Mme. Louis Goulet
  _Angus_             |Essa           |Simcoe, S. R.    |John Mather
  Antrim              |Fitzroy        |Carleton         |John Shields
  Appin               |Ekfrid         |Middlesex, W. R. |J. D. R. McLean
  Appleby             |Nelson         |Halton           |T. A. Atkinson
  Appleton            |Ramsay         |Lanark, N. R.    |Albert Teskey
  Apto                |Flos           |Simcoe, N. R.    |D. Gallagher
  Argyle              |Eldon          |Victoria         |Donald McEachern
  _Arkona_            |Bosanquet      |Lambton          |Levi Schooley
  Arkwright           |Arran          |Bruce            |J. Faulkner
  Arlington           |Adjala         |Simcoe, S. R.    |Thomas Kidd
  Armagh              |Armagh         |Bellechasse      |Neil McNeil
  Arnprior            |McNab          |Renfrew          |Andrew Russell
  Artemesia           |Artemesia      |Grey             |James P. Fowler
  Arthabaska Station  |Arthabaska     |Arthabaska       |Louis Foisy
  Arthur              |Arthur         |Wellington, N. R.|William Mitchell
  Arva                |London         |Middlesex, E. R. |W. B. Bernard
  Ashburn             |Whitby         |Ontario, S. R.   |Edward Olver
  Ashburnham          |Otanabee       |Peterborough     |Robert D. Rogers
  Ashgrove            |Esquesing      |Halton           |John Hunter
  Ashton              |Goulburn       |Carleton         |John Sumner
  Ashworth            |Scott          |Ontario, N. R.   |J. Tomlinson
  Athelstan           |Hinchinbrooke  |Huntingdon       |Harvey Mills
  Athens              |Scott          |Ontario, N. R.   |R. Bingham
  Atherly             |Mara           |Ontario, N. R.   |W. C. McMullen
  Athlone             |Adjala         |Simcoe, S. R.    |John Kidd
  Athol               |Indian Reserve |Glengary         |George McDonell
  Auburn              |Colborne       |Huron            |James Sutherland
  Audley              |Pickering      |Ontario, S. R.   |Robert Graham
  Aughrim             |Euphemia       |Lambton          |J. McKeune
  _Aultsville_        |Osnabruck      |Stormont         |J. R. Ault
  _Aurora_            |Whitchurch     |York, N. R.      |Charles Doan
  Avoca               |Grenville      |Argenteuil       |John McCallum
  Avon                |Dorchester     |Middlesex, E. R. |Simon Whaley
  Avon Bank           |Downie         |Perth            |James Muir
  _Aylmer (East)_     |Hull           |Ottawa           |J. R. Woods
  _Aylmer (West)_     |Malahide       |Elgin, E. R.     |Philip Hodgkinson
  Aylwin              |Aylwin         |Ottawa           |J. Little
  _Ayr_               |Dumfries       |Waterloo, S. R.  |Robert Wylie
  Ayton               |Normanby       |Grey             |John McPhillips
                      |               |                 |
                      |               |                 |
  Baby’s Point        |Sombra         |Lambton          |
  Babyville           |Sherrington    |Napierville      |Humphrys Nesbitt
  Baden               |Wilmot         |Waterloo, S. R.  |Jacob Beck
  Bagot               |Bagot          |Renfrew          |Felix Devine
  Bagotville          |Bagot          |Chicoutimi       |L. Z. Rousseau
  Baillargeon         |St. Etienne de |Levi             |A. Simoneau
                      |  Lauzon       |                 |
  Baillieboro’        |Cavan          |Durham, E. R.    |James Fitzgerald
  Balderson           |Bathurst       |Lanark, S. R.    |A. McDonald
  Baldwin             |Camden         |Addington        |Gordon P. York
  Ballantrae          |Whitchurch     |York, N. R.      |
  Ballinafad          |Erin           |Wellington, S. R.|John S. Applebe
  Ballycroy           |Adjala         |Simcoe, S. R.    |John McClelland
  Ballyduff           |Manvers        |Durham, E. R.    |W. A. Maxwell
  Ballymote           |London         |Middlesex, W. R. |J. W. O’Brien
  Ballynahinch        |Kingston       |Frontenac        |Robert Gibson
  Balmoral            |Walpole        |Haldimand        |Lewis Auguish
  Balsam              |Pickering      |Ontario, S. R.   |Robert Dodds
  Baltimore           |Hamilton       |Northumberl’d,   |John Gilbard
                      |               |  W. R.          |
  Bamberg             |Wellesley      |Waterloo, N. R.  |F. Walter
  Banda               |Mulmur         |Simcoe, S. R.    |John Cleminger
  Bandon              |Hullett        |Huron            |John Leighton
  Bangor              |Pickering      |Ontario, S. R.   |Isaac Turner
  Bannockburn         |Madoc          |Hastings, N. R.  |W. H. Carpenter
  Barnett             |Nichol         |Wellington, N. R.|James Elmslie
  Barnston            |Barnston       |Stanstead        |John Humphrey
  _Barrie_            |Vespra         |Simcoe, N. R.    |Alfred Lane
  Barrington          |Hemmingford    |Huntingdon       |Oliver Lyttle
  Bartonville         |Barton         |Wentworth, S. R. |S. F. Depew
  _Bath_              |Ernestown      |Addington        |W. J. Fairfield
  Batiscan            |Batiscan       |Champlain        |D. Lacourcière
  Batiscan Bridge     |Batiscan       |Champlain        |J. Fugère
  Battersea           |Storrington    |Frontenac        |Cornelius Vanluven
  _Bayfield_          |Stanley        |Huron            |James Gairdner
  Bayham              |Bayham         |Elgin, E. R.     |Thomas Springall
  Beachburg           |Westmeath      |Renfrew          |George Surtees
  _Beachville_        |Oxford, W.     |Oxford, S. R.    |H. J. Moore
  _Beamsville_        |Clinton        |Lincoln          |J. B. Osborne
  Bear Brook          |Cumberland     |Russell          |W. H. Walsh
  Beauharnois         |Beauharnois    |Beauharnois      |Ovide Payment
  Beaumont            |Beaumont       |Bellechasse      |Z. Turgeon
  Beauport            |Beauport       |Quebec           |Patrick O’Brien
  _Beaverton_         |Thora          |Ontario, N. R.   |Donald Cameron
  Becancour           |Becancour      |Nicolet          |B. Rivard
  Bedford             |Stanbridge     |Missisquoi       |Nelson Adams
  Belfast             |Ashfield       |Huron            |
  Belford             |Markham        |York, E. R.      |Israel Burton
  Belfountain         |Caledon        |Peel             |Noah Herring
  Belle Rivière       |               |Two Mountains    |F. X. Brazeau
  _Belleville_        |Thurlow        |Hastings, S. R.  |J. H. Meacham
  Bell Ewart          |Innisfil       |Simcoe, S. R.    |P. Edward Drake
  Bellrock            |Portland       |Frontenac        |D. Brown
  Bell’s Corners      |Nepean         |Carleton         |George Arnold
  Belmont             |Dorchester, S. |Elgin, E. R.     |James Waterberry
  Belmore             |Turnberry      |Huron            |F. W. Irwin
  Belœil Station      |Belœil         |Verchères        |S. Dillon
  Belœil Village      |do.            |do.              |J. R. Brillon
  Benmiller           |Colborne       |Huron            |Edwin Gledhill
  Bennie’s Corners    |Ramsay         |Lanark, N. R.    |Alex. Leishman
  Bensfort            |South Monaghan |Northumberl’d,   |James W. McBain
                      |               |  W. R.          |
  _Bentinck_          |Bentinck       |Grey             |A. B. McNab
  Beresford           |Beresford      |Terrebonne       |V. Charbonneau
  Berkeley            |Holland        |Grey             |John Fleming
  _Berlin_            |Waterloo, N.   |Waterloo, N. R.  |William Jaffray
  Berthier, en bas    |Berthier       |Montmagny        |F. X. Corriveau
  _Berthier, en haut_ |Berthier       |Berthier         |Alex. Kittson
  Bervie              |Kincardine     |Bruce            |Nichol McIntyre
  Berwick             |Finch          |Stormont         |J. A. Cockburn
  Bethany             |Manvers        |Durham, E. R.    |F. Bleakley
  Bethune             |Grenville      |Argenteuil       |D. McArthur
  Bewdley             |Hamilton       |Northumberl’d,   |John Sidey
                      |               |  W. R.          |
  Bic                 |Bic            |Rimouski         |J. R. Colclough
  Binbrook            |Binbrook       |Wentworth, S. R. |Henry Hall
  Birchton            |Eaton          |Compton          |J. McNeight
  Birkhall            |Moore          |Lambton          |F. McKenzie
  Birmingham          |Pittsburg      |Frontenac        |Mrs. E. Birmingham
  Birr                |London         |Middlesex, E. R. |Elias Place
  Bishop’s Mills      |Oxford         |Grenville, N. R. |Asa W. Bishop
  Black Creek         |Willoughby     |Welland          |J. H. Allen
  Black River Station |St. Giles      |Lotbinière       |Louis Olivier
  Blair               |Waterloo, S.   |Waterloo, S. R.  |W. Bowman
  Blandford           |Blandford      |Arthabaska       |T. Laflèche
  Blessington         |Tyendinaga     |Hastings, S. R.  |John Lally
  Bloomfield          |Hallowell      |Prince Edward    |Jonathan Striker
  Bloomingdale        |Waterloo       |Waterloo, N. R.  |J. G. Moyer
  Bloomsburg          |Townsend       |Norfolk          |M. M. Kitchen
  Bluevale            |Turnberry      |Huron            |John Messer
  Blyth               |Morris         |Huron            |Wm. Drummond
  Blytheswood         |Mersea         |Essex            |John Hope
  _Bobcaygeon_        |Verulam        |Victoria         |Mossom Boyd
  Bodmin              |Morris         |Huron            |William Harris
  Bogart              |Hungerford     |Hastings, N. R.  |James McIntosh
  Bomanton            |Haldimand      |Northumberl’d,   |Richard Knight
                      |               |  W. R.          |
  Bonaventure         |Hamilton       |Bonaventure      |Rev’d. J. L. Alain
  _Bondhead_          |Tecumseth      |Simcoe, S. R.    |Mrs. St. Clair
  Bongard’s Corners   |Marysburgh     |Prince Edward    |John Bongard
  Bord à Plouffe      |Between Isle of|Laval            |V. Lemay
    Sub Office        |  Montreal and |                 |
                      |  Isle Jesus   |                 |
  Boscobel            |Ely            |Shefford         |William Hackwell
  Boston              |Townsend       |Norfolk          |Oliver C. Rouse
  [1]Bosworth         |Peel           |Wellington, N. R.|M. Snyder
  _Bothwell_          |Zone           |Kent             |Capt. John Taylor
  Boucherville        |Boucherville   |Chambly          |Louis Normandin
  Bourg Louis         |Bourg Louis    |Portneuf         |E. A. Panet
  Bowen               |Richmond       |Lenox            |James Bowen
  _Bowmanville_       |Darlington     |Durham, W. R.    |J. B. Fairbairn
  Bowmore             |Nottawasaga    |Simcoe, N. R.    |James Russell
  Bowood              |Lobo           |Middlesex        |Archibald Bell
  Boyne               |Trafalgar      |Halton           |E. McLernan
  _Bradford_          |W. Gwillimbury |Simcoe, S. R.    |Mrs. Anne Douglas
  Braemar             |E. Zorra       |Oxford, N. R.    |John Forbes, Jr.
  _Brampton_          |Chinguacousy   |Peel             |K. Chisholm
  Branchton           |Dumfries, N.   |Waterloo, S. R.  |Andrew Burnet
  _Brantford_         |Brantford      |Brant, W. R.     |A. D. Clement
  Breadalbane         |Lochiel        |Glengary         |P. M. Stewart
  Breslaw             |Waterloo       |Waterloo, N. R.  |
  Brewer’s Mills      |Pittsburgh     |Frontenac        |Robert Anglin
  Brewster            |Hay            |Huron            |J. H. Cook
  Bridgenorth         |Smith          |Peterboro’       |Marcus S. Dean
  Bridgeport          |Waterloo, N.   |Waterloo, N. R.  |P. N. Tagge
  Bridgewater         |Elzevir        |Hastings, N. R.  |G. W. Wood
  Brigham             |Farnham        |Brome            |E. O. Brigham
  _Brighton_          |Murray         |Northumberl’d,   |Joseph Lockwood
                      |               |  E. R.          |
  Brinkworth          |Rawdon         |Hastings, N. R.  |A. Fullerton
  Bristol             |Bristol        |Pontiac          |William King
  Britonville         |Morin          |Argenteuil       |George Hamilton
  Brock               |Brock          |Ontario, N. R.   |Archibald Jones
  _Brockville_        |Elizabethtown  |T’n of Brockville|John Crawford
  Brome               |Brome          |Brome            |Henry R. Williams
  Bromemere           |Outlet of Brome|do.              |C. H. Jones
                      |  Lake         |                 |
  Brompton            |Brompton       |Richmond         |E. B. Stevens
  Brompton Falls      |do.            |do.              |James Dean
  Bronte              |Trafalgar      |Halton           |Thos. C. Hagaman
  _Brooklin_          |Whitby         |Ontario, S. R.   |Robert Darlington
  Brooksdale          |West Zorra     |Oxford, N. R.    |John Innis
  Brougham            |Pickering      |Ontario, S. R.   |Richard Taun
  Broughton           |Broughton      |Megantic         |C. H. J. Hall
  Brownsburg          |Chatham        |Argenteuil       |Alex. McGibbon
  Brownsville         |Dereham        |Oxford, S. R.    |E. McDiarmid
  Brucefield          |Stanley        |Huron            |Robert H. Gairdner
  Bruce Mines         |        On Lake|Huron            |J. Coatsworth
  Brudenell           |Brudenell      |Dist. of         |John Reynolds
                      |               |  Nipissing      |
  Brunswick           |Manvers        |Durham, E. R.    |S. R. Beamish
  Buckhorn            |Harwich        |Kent             |Hugh McPherson
  Buckingham          |Buckingham     |Ottawa           |James Wilson
  Buckland            |Buckland       |Bellechasse      |C. Goulet
  Bulstrode           |Bulstrode      |Arthabaska       |T. Geoffroy, Jr.
  Bulwer              |Eaton          |Compton          |
  _Burford_           |Burford        |Brant, W. R.     |John Catton
  Burgessville        |Norwich        |Oxford, S. R.    |Josiah Campbell
  Burn-brae           |Seymour        |Northumberl’d,   |Alex. Donald
                      |               |  E. R.          |
  Burnhamthorpe       |Toronto        |Peel             |Geo. Savage
  Burns               |Mornington     |Perth            |W. Cousins
  Burnstown           |McNab          |Renfrew          |James Douglas
  Burritt’s Rapids    |Oxford         |Grenville, N. R. |John Meikle, Jr.
  Burtch              |Brantford      |Brant, W. R.     |Geo. Taylor
  Burton              |Manvers        |Durham, E. R.    |James McGill
  Bury’s Green        |Somerville     |Victoria         |John Fell
  Bute                |Somerset       |Megantic         |J. McKinnon
  Buttonville         |Markham        |York, E. R.      |Francis Plebs
  Buxton              |Raleigh        |Kent             |Rev’d. W. King
  Byron               |Westminster    |Middlesex, E. R. |Robert Sadler
                      |               |                 |
                      |               |                 |
  Cacouna             |Cacouna        |Temiscouata      |J. B. Beaulieu
  Cæsarea             |Cartwright     |Durham, W. R.    |James Cæsar
  Cainsville          |Brantford, E.  |Brant, E. R.     |Margaret Grenny
  Caintown            |Yonge          |Leeds, S. R.     |W. Tennant
  Caistor             |Caistor        |Lincoln          |James Tisdale
  Caistorville        |do.            |do.              |M. G. Scott
  Calabogie           |Bagot          |Renfrew          |D. Dillon
  Caldwell            |Caledon        |Peel             |Patrick Murphy
  Caledon             |do.            |do.              |George Bell
  Caledon East        |do.            |do.              |James Munsie
  Caledonia Springs   |Caledonia      |Prescott         |William Lendrum
  Calumet Island      |Calumet        |Pontiac          |Louis Brisard
  Camborne            |Hamilton       |Northumberl’d,   |George Stewart
                      |               |  W. R.          |
  Cambray             |Fenelon        |Victoria         |William Hunter
  Camden East         |Camden East    |Addington        |Samuel Clark
  Cameron             |Fenelon        |Victoria         |James Bryson
  Camilla             |Mono           |Simcoe, S. R.    |Hugh Currie
  Campbellford        |Seymour        |Northumberl’d,   |A. S. Platt
                      |               |  E. R.          |
  Campbell’s Cross    |Chinguacousy   |Peel             |E. T. Hagyard
  Campbellville       |Nassagiweya    |Halton           |F. J. Jones
  Campden             |Clinton        |Lincoln          |H. W. Moyer
  Canboro’            |Canboro’       |Haldimand        |H. C. Birdsall
  Canfield            |Cayuga         |Haldimand        |John Wilson
  Cannifton           |Thurlow        |Hastings, S. R.  |Jonas Cannif, Jr.
  Canning             |Blenheim       |Oxford, N. R.    |
  Cannington          |Brock          |Ontario, N. R.   |Charles Gibbs
  Canrobert           |               |Rouville         |James Malarkey
  Cantley             |Hull           |Ottawa           |George Brown
  Canton              |Hope           |Durham, E. R.    |William Deacon
  Cap Chat            |               |Gaspé            |F. G. Lamontagne
    (sub office)      |               |                 |
  Cape Cove           |Percé          |Gaspé            |William Tilly
  Cape Rich           |St. Vincent    |Grey             |Donald McLaren
  Cap Magdeleine      |               |Champlain        |Sévère Rocheleau
  Cap Rouge           |St. Foy        |Quebec           |Charles Drolet
  Cap St. Ignace      |               |Montmagny        |Miss H. C. Larue
  Cap Santé           |Portneuf       |Portneuf         |G. A. Allsopp
  Carden              |Carden         |Victoria         |R. Delaney
  Carillon            |Chatham        |Argenteuil       |George Schneider
  Carleton, (B. C.)   |Carleton       |Bonaventure      |Joseph Meagher
  _Carleton Place_    |Beckwith       |Lanark, S. R.    |Paul Struthers
  Carlingford         |Fullarton      |Perth            |A. Davidson
  Carlisle            |Flamboro’, East|Wentworth, N. R. |John C. Crooker
  Carlow              |Colborne       |Huron            |James McDonagh
  Carlton West        |York           |York, W. R.      |E. S. Tiernay
  Carluke             |Ancaster       |Wentworth, S. R. |James Calder
  Carp                |Huntley        |Carleton         |W. J. Fetherston
  Carronbrook         |Logan          |Perth            |Joseph Kidd
  Carthage            |Mornington     |Perth            |Charles Brown
  Cartwright          |Cartwright     |Durham, W. R.    |William Vance
  Cashel              |Markham        |York, E. R.      |Samuel Jennings
  Cashmere            |Mosa           |Middlesex, W. R. |George Mansfield
  Casselman           |Cambridge      |Russell          |John Casselman
  Castlebar           |Shipton        |Richmond         |Roderick McLeay
  Castleford          |Horton         |Renfrew          |E. Ferrall
  Castlemore          |Gore of Toronto|Peel             |John Murphy
  Castleton           |Cramahe        |Northumberl’d,   |John C. Pennock
                      |               |  W. R.          |
  Cathcart            |Burford        |Brant, W. R.     |Thomas Muir
  Caughnawaga         |Sault St. Louis|Laprairie        |Robert McNabb
  Cavagnol            |Vaudreuil      |Vaudreuil        |John A. Mathison
  Cavan               |Cavan          |Durham, E. R.    |William Graham
  _Cayuga_            |Cayuga         |Haldimand        |G. A. Messenger
  Cedar Grove         |Markham        |York, E. R.      |Michael Brooks
  Cedar Hill          |Pakenham       |Lanark, N. R.    |S. Dickson
  Cedars              |Soulanges      |Soulanges        |Benjamin Joassim
  Cedarville          |Proton         |Grey             |Thomas Rogers
  Centre Augusta      |Augusta        |Grenville, S. R. |Horace McLean
  Centreton           |Haldimand      |Northumberl’d,   |T. H. McAuley
                      |               |  W. R.          |
  Centreville         |Camden, East   |Addington        |James N. Lapum
  Chambly Basin       |Chambly        |Chambly          |Dr. Ph. B.
                      |               |                 |  Verchères de
                      |               |                 |  Boucherville
  _Chambly Canton_    |West Chambly   |do.              |John Hackett
  Champlain           |Champlain      |Champlain        |J. E. Lanouette
  Charing Cross       |Harwich        |Kent             |Jane Gay
  Charlesbourg        |Quebec         |Quebec           |M. Tremblay
  Charleston          |Escott         |Leeds, S. R.     |P. F. Green
  Charleville         |Augusta        |Grenville, S. R. |Samuel Throop
  Chateauguay         |Chateauguay    |Chateauguay      |N. Mallet
  Chateauguay Basin   |do.            |do.              |John Jack, Sr.
  Chateau Richer      |Montmorency    |Montmorency      |Mdme. L. B.
                      |               |                 |  Rousseau
  Chatham (East)      |Chatham        |Argenteuil       |James B. Cushing
  _Chatham (West)_    |Raleigh        |Kent             |B. F. Barfoot
  Chatsworth          |Holland        |Grey             |Henry Cardwell
  Cheapside           |Walpole        |Haldimand        |William Lamb
  Chelsea             |Hull           |Ottawa           |Nicholas Link
  Cheltenham          |Chinguacousy   |Peel             |William Allan
  Cherry Creek        |Innisfil       |Simcoe, S. R.    |William Main
  Cherry Valley       |Athol          |Prince Edward    |Isaiah T. Insley
  Chertsey            |Chertsey       |Montcalm         |Magloire Granger
  Chester             |Chester        |Arthabaska       |Jasper Emerson
  Chesterfield        |Blenheim       |Oxford, N. R.    |George Baird
  Chichester          |Chichester     |Pontiac          |Joseph Bargeron
  Chicoutimi          |Chicoutimi     |Chicoutimi       |John Guay
  _Chippawa_          |Stamford       |Welland          |Mrs. Anne Hepburn
  Churchill           |Innisfil       |Simcoe, S. R.    |H. Sloane
  Churchville         |Toronto        |Peel             |William Duggan
  Clachan             |Aldboro’       |Elgin, W. R.     |J. Marchbank
  Claremont           |Pickering      |Ontario, S. R.   |J. McM. McNab
  Clarence            |Clarence       |Russell          |Richard Woodley
  Clarenceville       |Noyan          |Missisquoi       |Charles Stewart
  Clarendon           |Clarendon      |Pontiac          |A. Wilson
  Clarendon Centre    |do.            |do.              |James Shaw
  Clareview           |Sheffield      |Addington        |Samuel C.
                      |               |                 |  McDonnell
  Clarke              |Clarke         |Durham, W. R.    |James Lockhart
  Clarksburg (Sub)    |Collingwood    |Grey             |
  Claude              |Chinguacousy   |Peel             |Henry Perdue
  Clayton             |Ramsay         |Lanark, N. R.    |O. Banning, Jr.
  Clear Creek         |Houghton       |Norfolk          |Jonathan Bridgman
  Clearville          |Orford         |Kent             |John Scott
  Clifford            |Minto          |Wellington, N. R.|T. Brown
  _Clifton_           |Stamford       |Welland          |J. W. Dunklee
  [2]Clifton House    |Stamford       |Welland          |J. Shears
    (Sub)             |               |                 |
  _Clinton_           |Tuckersmith    |Huron            |Thomas Fair
  Clontarf            |Sebastopol     |Renfrew          |T. P. French
  Clover Hill         |Essa           |Simcoe, S. R.    |Thomas Saunders
  Cloyne              |Barrie         |Frontenac        |F. Clark
  Clunas              |Dorchester, S. |Elgin, E. R.     |W. H. Graves
  Clyde               |Beverley       |Wentworth, N. R. |W. McPherson
  _Coaticook_         |Barford        |Stanstead        |Horace Cutting
  Cobden              |Ross           |Renfrew          |Jason Gould
  Coboconk            |Bexley         |Victoria         |J. H. Cronk
  _Cobourg_           |Hamilton       |Northumberl’d,   |Thomas Scott
                      |               |  W. R.          |
  Codrington          |Brighton       |Northumberl’d,   |William Shaw
                      |               |  E. R.          |
  _Colborne_          |Cramahe        |do.              |C. R. Ford
  Colchester          |Colchester     |Essex            |John Cheyne
  Coldsprings         |Hamilton       |Northumberl’d,   |D. McIntosh
                      |               |  W. R.          |
  Coldwater           |Medonte        |Simcoe, N. R.    |James Shaw
  Colebrook           |Camden, East   |Addington        |Charles Warner
  Coleraine           |Toronto Gore   |Peel             |Thomas
                      |               |                 |  Shuttleworth
  Colinville          |Moore          |Lambton          |John Butler
  Collfield           |Litchfield     |Pontiac          |M. Hughes
  _Collingwood_       |Nottawasaga    |Simcoe, N. R.    |W. B. Hamilton
  Collin’s Bay        |Kingston       |Frontenac        |Lawrence Herchmer
  Columbus            |Whitby         |Ontario, S. R.   |Robert Ashton
  Comber              |Tilbury, West  |Essex            |Henry Reichenbach
  Como                |Vaudreuil      |Vaudreuil        |John Hodgson
  _Compton_           |Compton        |Compton          |A. W. Kendrick
  Concord             |Vaughan        |York, W. R.      |John Duncan
  Conestogo           |Woolwich       |Waterloo, N. R.  |William Hendry
  Consecon            |Hillier        |Prince Edward    |A. Marsh
  Constance           |Hullet         |Huron            |John Lawson
  Contrecœur          |Contrecœur     |Verchères        |Olivier Lamoureux
  Conway              |Fredericksburg |Lenox            |E. Howard
  Cookshire           |Eaton          |Compton          |R. H. Wilford
  _Cookstown_         |Essa           |Simcoe, S. R.    |W. McClain
  _Cooksville_        |Toronto        |Peel             |F. B. Morley
  Cooper              |Madoc          |Hastings, N. R.  |Robert Kinnear
  Copetown            |Beverley       |Wentworth, N. R. |Thomas Milne
  _Cornwall_          |Cornwall       |Town of Cornwall |G. C. Wood
  Corunna             |Moore          |Lambton          |H. J. Miller
  Côteau du Lac       |Soulanges      |Soulanges        |A. St. Amour
  Côteau Landing      |do.            |do.              |John Bermingham
  Côteau Station      |do.            |do.              |Rodger Duckett
  Côte des Neiges     |Montreal       |Hochelaga        |R. Robertson
  Côte St. Paul       |Montreal       |Hochelaga        |F. X. Chauvin
  Coventry            |Albion         |Peel             |Alexander Hamilton
  Covey Hill          |Hemmingford    |Huntingdon       |W. Barrett
  Cowansville         |Durham         |Missisquoi       |W. H. Kathan
  _Craighurst_        |Flos           |Simcoe, N. R.    |John Craig
  Craigleith          |Collingwood    |Grey             |A. G. Fleming
  Cranbourne          |Cranbourne     |Dorchester       |John Colgan
  _Credit_            |Toronto        |Peel             |James Magrath
  Crediton            |Stephen        |Huron            |John Parsons
  Creek Bank          |Peel           |Wellington, N. R.|James Graham
  Creemore            |Nottawasaga    |Simcoe, N. R.    |George J. Bolster
  Cressy              |Marysburg      |Prince Edward    |S. W. Carson
  Crinan              |Alboro’        |Elgin, W. R.     |D. McIntyre
  Cromarty            |Hibbert        |Perth            |Robert Leggatt
  Crosshill           |Wellesley      |Waterloo, N. R.  |James McCutcheon
  Crosspoint          |Restigouche    |Bonaventure      |John Fraser
  Croton              |Camden         |Kent             |J. H. Johnston
  Crowland            |Crowland       |Welland          |Luther Boardman
  Croydon             |Camden, E.     |Addington        |John M. Williams
  Crysler             |Finch          |Stormont         |E. K. Johnstone
  Culloden            |Dereham        |Oxford, S. R.    |Mrs. M. McKenzie
  Cumminsville        |Nelson         |Halton           |Robert Thomson
  Cumnock             |Nichol         |Wellington, N. R.|James Samson
  Curran              |Plantagenet    |Prescott         |P. Gareau
                      |               |                 |
                      |               |                 |
  Daillebout          |De Ramsay      |Joliette         |L. J. Deziel
  Dalesville          |Rear of Chatham|Argenteuil       |Peter McArthur
  Dalhousie Mills     |Lochiel        |Glengary         |William Chisholm
  Dalston             |Vespra         |Simcoe, N. R.    |H. A. Clifford
  Danforth            |Scarboro’      |York, E. R.      |Henry Hogarth
  _Danville_          |Shipton        |Richmond         |J. W. Stockwell
  Dartford            |Percy          |Northumberl’d,   |William Bailey
                      |               |  E. R.          |
  Davenport           |York           |York, W. R.      |George S. Yearley
  Dawn Mills          |Gore of Camden |Kent             |James Smith
  Dealtown            |Tilbury, East  |Kent             |Isaac Russell
  De Cewsville        |Cayuga         |Haldimand        |T. B. Dier
  Delaware            |Delaware       |Middlesex, W. R. |C. J. Ladd
  Delhi               |Middleton      |Norfolk          |James Whitsides
  Delta               |Bastard        |Leeds            |W. H. Denant
  Demorestville       |Sophiasburg    |Prince Edward    |B. Smith
  Denison’s Mills     |Shipton        |Richmond         |Joseph R. Denison
  Deniston            |Hinchinbrooke  |Frontenac        |J. J. Wilson
  De Ramsay           |De Ramsay      |Joliette         |James Read
  _Dereham_           |Dereham        |Oxford, S. R.    |Lachlen McLean
  Derry West          |Toronto        |Peel             |William McClare
  Deschambault        |Deschambault   |Portneuf         |François Hamelin
  Détour du Lac       |               |Temiscouata      |Mdme. A. Cloutier
  Devizes             |London         |Middlesex, E. R. |B. Armstrong
  _Devon_             |Stephen        |Huron            |James Stephenson
  Dewittville         |               |Huntingdon       |Joseph Oliver
  Dexter              |Yarmouth       |Elgin, E. R.     |W. Collier
  Diamond             |Fitzroy        |Carleton         |R. Walker, Jr.
  _Dickinson’s        |Osnabruck      |Stormont         |William Colquhoun
    Landing_          |               |                 |
  Dingle              |Grey           |Huron            |William Grant
  Dixon’s Corners     |Matilda        |Dundas           |William Wood
  Donegal             |Elma           |Perth            |J. R. Foster
  Doon                |Waterloo, North|Waterloo, N. R.  |
  Doran               |Bathurst       |Lanark, S. R.    |William Doran
  Dorchester          |Dorchester,    |Middlesex, E. R. |Thomas Putnam
                      |  North        |                 |
  Dorchester Station  |Dorchester     |do.              |J. N. Hardy
  Douglas             |Bromley        |Renfrew          |A. W. Bell
  Douglastown         |Douglas        |Gaspé            |Charles Veit
  Dover South         |Dover          |Kent             |Charles Barillier
  Downeyville         |Emily          |Victoria         |Michael Lehane
  Drayton             |Peel           |Wellington, N. R.|James Echlin
  Dresden             |Gore of Camden |Kent             |C. P. Watson
  Drew’s Mills        |Barford        |Stanstead        |Alfred Parker
  Drumbo              |Blenheim       |Oxford, N. R.    |James McKenzie
  Drummondville, E.   |Grantham       |Drummond         |James Millar
  _Drummondville, W._ |Stamford       |Welland          |Peter Ker
  Drumquin            |Trafalgar      |Halton           |T. H. Patterson
  Duart               |Orford         |Kent             |James Tait, Sr.
  Dudswell            |Dudswell       |Wolfe            |Zerah Evans
  Dumblane            |Saugeen        |Bruce            |John Fraser
  Dunany              |Wentworth      |Argenteuil       |Samuel Smith
  Dunbar              |Williamsburg   |Dundas           |William Beckstedt
  Dunbarton           |Pickering      |Ontario, S. R.   |John Parker
  Duncrief            |Lobo           |Middlesex, W. R. |James Barnes
  Dundalk             |Melancthon     |Grey             |Elias B. Grey
  _Dundas_            |Flamboro’, West|Wentworth, N. R. |J. M. Thornton
  Dundee              |Godmanchester  |Huntingdon       |David Baker
  Dungannon           |Wawanosh       |Huron            |R. Clendinning
  Dunham              |Dunham         |Missisquoi       |Edward Baker
  Dunkeld             |Brant          |Bruce            |Andrew Brown
  _Dunnville_         |Moulton        |Haldimand        |John Armour
  Dunvegan            |Kenyon         |Glengary         |Hector McLean
                      |               |                 |
                      |               |                 |
  Eardley             |Eardley        |Ottawa           |Wyman C. Davis
  East Arthabaska     |Arthabaska     |Arthabaska       |P. N. Pacaud
  East Bolton         |Bolton         |Brome            |Amos Austin
  East Clifton        |Clifton        |Compton          |Hugh E. Cairns
  East Dunham         |Dunham         |Missisquoi       |Orlin Wales
  East Farnham        |Farnham        |Brome            |Rodney Hutchins
  East Frampton       |Frampton       |Dorchester       |James Kennedy
  East Glenelg        |Glenelg        |Grey             |Eliza L. Atkinson
  East Hawkesbury     |Hawkesbury     |Prescott         |James Gamble
  East Hereford       |Hereford       |Compton          |C. W. Prouty
  Easton’s Corners    |Wolford        |Grenville, N. R. |W. G. Ferguson
  East Oro            |Oro            |Simcoe, N. R.    |William Simpson
  East Templeton      |Templeton      |Ottawa           |Lewis Dunning
  East Williamsburg   |Williamsburg   |Dundas           |Lindsay Pillar
  Eastwood            |Oxford, South  |Oxford, S. R.    |Henry Vansittart
  Eaton               |Eaton          |Compton          |Joshua Foss
  Eddystone           |Haldimand      |Northumberl’d,   |M. Bradley
                      |               |  W. R.          |
  Eden                |Bayham         |Elgin, E. R.     |John Nethercott
  Eden Mills          |Eramosa        |Wellington, S. R.|Samuel Meadows
  Edgecombe           |Mornington     |Perth            |Thomas Martin
  Edgeworth           |Tilbury, East  |Kent             |John Ker
  Edmonton            |Chinguacousy   |Peel             |James
                      |               |                 |  Collingbourne
  Edwardsburgh        |Edwardsburgh   |Grenville, S. R. |William S. Akin
  Eganville           |Grattan        |Renfrew          |John Quealy
  Eglinton            |York           |York, E. R.      |Joseph Hargrave
  Egmondville         |Tuckersmith    |Huron            |T. J. Marks
  Egremont            |Egremont       |Grey             |Thomas Smith
  Eldon               |Eldon          |Victoria         |Angus Ray
  Elgin               |Crosby, South  |Leeds, S. R.     |Philemon Pennock
  Elginburg           |Kingston       |Frontenac        |Peter Bates
  Elginfield          |London         |Middlesex, E. R. |W. H. Ryan
  Elizabethville      |Hope           |Durham, E. R.    |J. McMurtry
  Ellengowan          |Divis’n Line   |Bruce            |
                      |  between Brant|                 |
                      |  & Elderslie  |                 |
  Ellesmere           |Scarboro’      |York, E. R.      |Arch. Glendinning
  Elm Grove           |Essa           |Simcoe, S. R.    |Richard Love
  Elmvale             |Flos           |Simcoe, N. R.    |William Harvey
  _Elora_             |Pilkington     |Wellington, N. R.|John Finlayson
  Elphin              |Sherbrooke,    |Lanark, N. R.    |
                      |  North        |                 |
  _Embro’_            |Zorra, West    |Oxford, N. R.    |D. Matheson
  Embrun              |Russell        |Russell          |Joseph Lalonde
  Emerald             |Amherst Island |Addington        |John Hitchin
  Ennis               |Enniskillen    |Lambton          |Charles Little
  Enniskillen         |Darlington     |Durham, W. R.    |John Pierce
  Ennismore           |Ennismore      |Peterboro’       |P. Gallivan
  Enterprise          |Camden, East   |Addington        |Robert Graham
  Epping              |Euphrasia      |Grey             |John Benson
  Epsom               |Reach          |Ontario, N. R.   |G. Fergusson
  Eramosa             |Eramosa        |Wellington, S. R.|J. E. Worsfold
  _Erin_              |Erin           |Wellington, S. R.|William Cornock
  Erinsville          |Sheffield      |Addington        |
  Erroll              |Plympton       |Lambton          |George Whiting
  Escott              |Yonge          |Leeds, S. R.     |Andrew Todd
  Esperance           |Ham            |Wolfe            |Pierre Prince
  Esquesing           |Esquesing      |Halton           |John Murray
  _Etobicoke_         |Etobicoke      |York, W. R.      |William Gamble
  Eugenia             |Artemesia      |Grey             |R. McLean Purdy
  Everton             |Eramosa        |Wellington, S. R.|D. F. Stewart
  Exeter              |Stephen        |Huron            |William Sanders
                      |               |                 |
                      |               |                 |
  Falkirk             |Williams       |Middlesex, W. R. |John H. Priestly
  Falkland            |Brantford      |Brant, W. R.     |M. Stally
  Farmersville        |Yonge          |Leeds, S. R.     |Arza Parish
  Farmington          |Amaranth       |Wellington, N. R.|John Curry
  Farnham Centre      |Farnham        |Brome            |John Johnston
  [3]Farquhar         |Usborne        |Huron            |William Edmond
  Farran’s Point      |Oznabruck      |Stormont         |George N. Hickey
  Fenaghvale          |Caledonia      |Prescott         |James Proudfoot
  Fenella             |Haldimand      |Northumberl’d,   |Thomas Frank
                      |               |  W. R.          |
  Fenelon Falls       |Fenelon        |Victoria         |James Fitzgerald
  Fenwick             |Pelham         |Welland          |J. Hume Taylor
  _Fergus_            |Nichol         |Wellington, N. R.|James McQueen
  Ferguson’s Falls    |Drummond       |Lanark, S. R.    |Robert Hicks
  Fermoy              |Bedford        |Frontenac        |Edward Botting
  Feversham           |Osprey         |Grey             |Mary Sproul
  _Fingal_            |Southwold      |Elgin, W. R.     |Samuel Tubby
  Fish Creek          |Blanshard      |Perth            |John Bell
  Fitch Bay           |Stanstead      |Stanstead        |Joseph Munro
  Fitzroy Harbour     |Fitzroy        |Carleton         |Robert Shirreff
  Fleetwood           |Manvers        |Durham, E. R.    |Thomas Russell
  Flinton             |Kaladar        |Addington        |Charles R. Flint
  Florence            |Euphemia       |Lambton          |G. P. Kerby
  Fonthill            |Pelham         |Welland          |John S. Rich
  Forest              |Plympton       |Lambton          |R. Dier
  Forester’s Falls    |Ross           |Renfrew          |Alexander Smith
  Forestville         |Charlotteville |Norfolk          |G. W. Griffin
  Forfar              |Bastard        |Leeds, S. R.     |W. H. Young
  Formosa             |Carrick        |Bruce            |F. X. Mesner
  Fort Coulonge       |Mansfield      |Pontiac          |Thomas Bryson
  _Fort Erie_         |Bertie         |Welland          |George Lewis
  Fort William        |               |Lake Superior    |Robert McVicar
  Fort William        |Esher          |Pontiac          |Hector McKenzie
  Fournier            |Plantagenet    |Prescott         |C. Fournier
  Foxboro’            |Thurlow        |Hastings, S. R.  |R. Papineau
  Fox River           |               |Gaspé            |J. C. Parant
  Frampton            |Frampton       |Dorchester       |M. Fitzgerald
  Frankford           |Sidney         |Hastings, S. R.  |William Gilbert
  Franktown           |Beckwith       |Lanark, S. R.    |E. McEwen
  Frankville          |Kitley         |Leeds, N. R.     |William Smith
  Freelton            |Flamboro’, West|Wentworth, N. R. |Thomas McKay
  Freiburg            |Waterloo, North|Waterloo, N. R.  |Ferdinand Romback
  Frelighsburg        |St. Armand     |Missisquoi       |W. M. Pattison
  French Village      |Kingsey        |Drummond         |François Pothier
  Frome               |Southwold      |Elgin, W. R.     |R. Kettlewell
  Frost Village       |Shefford       |Shefford         |Robert Craig
  Fullarton           |Fullarton      |Perth            |James Woodley
  Fulton              |Caistor        |Lincoln          |C. White
                      |               |                 |
                      |               |                 |
  Gad’s Hill          |North Easthope |Perth            |William Constable
  _Galt_              |Dumfries, North|Waterloo, S. R.  |John Davidson
  Galway              |Galway         |Peterboro’       |Thomas Probert
  _Gananoque_         |Leeds          |Leeds, S. R.     |D. F. Britton
  Garafraxa           |Garafraxa      |Wellington, N. R.|George Skene
  Garneau             |Lafontaine     |L’Islet          |D. Lizotte
  Garthby             |Garthby        |Wolfe            |David Grenier
  Gaspé Basin         |Gaspé          |Gaspé            |J. J. Kavanagh
  Geneva              |Argenteuil     |Argenteuil       |G. A. Hooker
  Gentilly            |Gentilly       |Nicolet          |Joseph O. Dion
  _Georgetown_        |Esquesing      |Halton           |Arthur Burnside
  Georgeville         |Stanstead      |Stanstead        |A. M. Bullock
  _Georgina_          |Georgina       |York, N. R.      |J. O. B. Bourchier
  Gilbert’s Mills     |Sophiasburgh   |Prince Edward    |Daniel Gilbert
  Glammis             |Bruce          |Bruce            |J. Crawford
  Glanford            |Glanford       |Wentworth, S. R. |John Atkinson
  Glanmire            |Tudor          |Hastings, N. R.  |Andrew Jelly
  Glanworth           |Westminster    |Middlesex, E. R. |R. J. Webb
  Glastonbury         |Kaladar        |Addington        |G. H. Comer
  _Glenallan_         |Peel           |Wellington, N. R.|George Allan
  Glenburnie          |Kingston       |Frontenac        |D. J. Waggoner
  Glencoe             |Ekfrid         |Middlesex, W. R. |Donald McRae
  Glenelg             |Glenelg        |Grey             |Mark Appleby
  Glenloyd            |Inverness      |Megantic         |
  Glenlyon            |Carrick        |Bruce            |J. Shannon
  Glen Morris         |Dumfries       |Brant, E. R.     |Gavin Fleming
  Glen Sutton         |Sutton         |Brome            |Daniel Dodge
  Glen William        |Esquesing      |Halton           |Charles Williams
  Goble’s Corners     |Blenheim       |Oxford, N. R.    |William L. Goble
  _Goderich_          |Goderich       |Huron            |James Watson
  Golden Creek        |Bosanquet      |Lambton          |Allen Kennedy
  Goodwood            |Uxbridge       |Ontario, N. R.   |Michael Chapman
  Gore’s Landing      |Hamilton       |Northumberl’d,   |William Brown
                      |               |  W. R.          |
  Gormley             |Markham        |York, E. R.      |James Gormley
  Gorrie              |Howick         |Huron            |Henry Besanson
  Gosfield            |Gosfield       |Essex            |Joseph Coatsworth
  Gosport             |Adolphustown   |Lenox            |Nicholas Bogart
  Gould               |Lingwick       |Compton          |James Ross
  Gourock             |Guelph         |Wellington, S. R.|James Mewhort
  Gower Point         |Westmeath      |Renfrew          |William Cannon
  _Grafton_           |Haldimand      |Northumberl’d,   |Cyrus Winter
                      |               |  W. R.          |
  Grahamsville        |Chinguacousy   |Peel             |Thomas Graham
  _Granby_            |Granby         |Shefford         |Horace Lyman
  Grande Baie         |Bagot          |Chicoutimi       |J. A. J. Kane
  Grande Grève        |               |Gaspé            |Charles Esnouf
  Grande Ligne        |               |St. Johns        |R. A. Girardin
  Grand River         |               |Gaspé            |Joseph O. Sirois
  Gravenhurst         |Muskoka        |Simcoe, N. R.    |James McCabe
  Greenbank           |Reach          |Ontario, N. R.   |John Asling
  Greenbush           |Elizabethtown  |Town of          |William Foster
                      |               |  Brockville     |
  Greenock            |Greenock       |Bruce            |
  Green Point         |Sophiasburg    |Prince Edward    |Philip Roblin
  Greensville         |West Flamboro’ |Wentworth, N. R. |James Joyce
  Greenwood           |Pickering      |Ontario, S. R.   |A. Fullarton
  _Grenville_         |Grenville      |Argenteuil       |Edwin Pridham
  Gresham             |Bruce          |Bruce            |E. J. Brown
  Grey                |Grey           |Huron            |William Tanner
  Griersville         |St. Vincent    |Grey             |Andrew Grier
  Griffith            |Griffith       |Renfrew          |W. B. Aird
  _Grimsby_           |Grimsby        |Lincoln          |J. A. Nelles
  Grondines           |Grondines      |Portneuf         |Jean Côté
  Grovesend           |Malahide       |Elgin, E. R.     |W. B. Lyon
  _Guelph_            |Guelph         |Wellington, S. R.|William Kingsmill
  Guysboro’           |Houghton       |Norfolk          |
                      |               |                 |
                      |               |                 |
  Hagersville         |Oneida         |Haldimand        |Charles Hager
  Halifax             |Halifax        |Megantic         |P. C. Pelletier
  Halloway            |Thurlow        |Hastings, S. R.  |William Peck
  Hall’s Bridge       |Harvey         |Peterboro’       |John Hall
  Ham                 |Ham            |Wolfe            |Louis C. Bourgeois
  Hamburg             |Fredericksburg |Lenox            |A. D. Fraser
  _Hamilton_          |Barton         |City of Hamilton |Edmund Ritchie
  Hampton             |Darlington     |Durham, W. R.    |H. Elliott
  Hannon              |Glanford       |Wentworth, S. R. |Joseph Hannon
  Hanover             |Bentinck       |Grey             |A. Z. Gottwalls
  Hardinge            |Barrie         |Frontenac        |A. Hawley Stevens
  Hargrave            |Litchfield     |Pontiac          |W. G. Le Roy
  Harlem              |Bastard        |Leeds, S. R.     |Wm. Gainsford
  Harley              |Burford        |Brant, W. R.     |J. L. McClellan
  Harold              |Rawdon         |Hastings, N. R.  |John Clark
  _Harpurhey_         |McKillop       |Huron            |M. MacDermid
  Harrietsville       |Dorchester     |Middlesex, E. R. |John McMillan
  Harrington, East    |Harrington     |Argenteuil       |Donald B. Campbell
  Harrington, West    |W. Zorra       |Oxford, N. R.    |D. L. Demorest
  Harrisburg          |Dumfries South |Brant, E. R.     |O. A. Spoor
  _Harriston_         |Minto          |Wellington, N. R.|A. Harrison
  Harrow              |Colchester     |Essex            |J. Munger
  Harrowsmith         |Portland       |Frontenac        |Samuel Stewart
  Hartford            |Townsend       |Norfolk          |
  Harvey Hill Mines   |Leeds          |Megantic         |P. M. Rogan
  Harwich             |Harwich        |Kent             |James Hutchison
  Harwood             |Hamilton       |Northumberl’d,   |R. Drope
                      |               |  W. R.          |
  Hastings            |Asphodel       |Peterboro’       |Henry Fowlds
  _Hatley_            |Hatley         |Stanstead        |W. G. Cook
  Havelock            |Belmont        |Peterboro’       |Peter Pearce
  _Hawkesbury_        |Hawkesbury     |Prescott         |Thomas Higginson
  Hawkstone           |Oro            |Simcoe, N. R.    |James Houston
  Hawksville          |Wellesley      |Waterloo, N. R.  |M. P. Empey
  Hay                 |Hay            |Huron            |James Murray
  Haysville           |Wilmot         |Waterloo, S. R.  |Margaret
                      |               |                 |  Somerville
  Hazledean           |Goulbourn      |Carleton         |John Young
  Headford            |Markham        |York, E. R.      |John Montgomery
  Head Lake           |Laxton         |Victoria         |James Riley
  Headville           |Grantham       |Drummond         |Henry Menut
  Heathcote           |Euphrasia      |Grey             |Thomas J. Rorke
  Hebron              |Elma           |Perth            |John Proudlove
  Heckstone           |South Gower    |Grenville, N. R. |G. Adams
  Heidelburg          |Woolwich       |Waterloo, N. R.  |John Krassler
  Hemmingford         |Hemmingford    |Huntingdon       |John Scriver
  Henry               |W. Hawkesbury  |Prescott         |C. W. Hamelin
  Henryville          |Sabrevois      |Iberville        |E. S. Goodnow
  Herdman’s Corners   |Hinchinbrooke  |Huntingdon       |John Johnston
  Hereford            |Hereford       |Compton          |Aaron Workman
  _Hespeler_          |Waterloo       |Waterloo, N. R.  |Conrad Nahrgang
  Hiawatha            |Otanabee       |Peterboro’       |Geo. Evans
  Highland Creek      |Scarboro’      |York, E. R.      |Eli Shackleton
  Hillier             |Hillier        |Prince Edward    |Solomon Flagler
  Hillsboro’          |Plympton       |Lambton          |Thomas L. Hill
  Hillsburgh          |Erin           |Wellington, S. R.|William How, Sr.
  Hilton              |Brighton       |Northumberl’d,   |R. J. Morrow
                      |               |  E. R.          |
  Hoath Head          |Sydenham       |Grey             |R. Hoath
  Hochelaga           |Island of      |Hochelaga        |F. Painchaud
                      |  Montreal     |                 |
  _Holland Landing_   |Gwillimbury    |York, N. R.      |W. J. Sloane
                      |  East         |                 |
  Hollen              |Maryborough    |Wellington, N. R.|S. Robertson
  Holmesville         |Goderich       |Huron            |Jonas Copp
  Holt                |E. Gwillimbury |York, N. R.      |John Quibell
  Holyrood            |Kinloss        |Bruce            |John Anderson
  Homer               |Grantham       |Lincoln          |Wm. Smith, Jun.
  Hopefield           |Radcliffe      |Dist. of         |H. Y. Read
                      |               |  Nipissing      |
  Hopetown            |Lanark         |Lanark, N. R.    |W. Rankin
  Hornby              |Esquesing      |Halton           |John McMillen
  Horning’s Mills     |Melancthon     |Grey             |Paul Jarvis
  Houghton            |Houghton       |Norfolk          |D. Jackson
  Howick              |S. Georgetown  |Chateauguay      |Thomas Gebbie
  Hubbell’s Falls     |Fitzroy        |Carleton         |James Reddell
  Hull                |Hull           |Ottawa           |G. J. Marston
  Hullsville          |Walpole        |Haldimand        |John Hull
  Humber              |Etobicoke      |York, W. R.      |Thomas Bell
  Humberstone         |Humberstone    |Welland          |John Thompson
  Hunterstown         |Hunterstown    |Maskinongé       |William Parker
  _Huntingdon_        |Godmanchester  |Huntingdon       |W. Marshall
  Huntingville        |Ascot          |Richmond         |Caleb P. Mallory
  Huntley             |Huntley        |Carleton         |John Graham
  Huston              |Maryboro’      |Wellington, N. R.|W. Robinson
  Hyde Park Corner    |London         |Middlesex, E. R. |John Squares
                      |               |                 |
                      |               |                 |
  _Indiana_           |Seneca         |Haldimand        |Thomas Slaven
  _Industry_          |               |Joliette         |L. T. Groulx
  _Ingersoll_         |Oxford, N.     |Oxford, S. R.    |Jos. Thirkell
  Inkerman            |Mountain       |Dundas           |John Renwick
  Innerkip            |E. Zorra       |Oxford, N. R.    |Robert Lindsay
  Innisfil            |Innisfil       |Simcoe, S. R.    |Benjamin Ross
  Innisville          |Drummond       |Lanark, S. R.    |Thomas Code
  Inverary            |Storrington    |Frontenac        |Hugh Ralston
  _Inverhuron_        |Bruce          |Bruce            |John Thorrington
  Invermay            |Arran          |Bruce            |Abraham Neelands
  Inverness           |Inverness      |Megantic         |Robert Layfield
  Iona                |Dunwich        |Elgin, W. R.     |William Harris
  Iron Hill           |Brome          |Brome            |Isaac Cutting
  _Iroquois_          |Matilda        |Dundas           |Jos. Grier
  Islay               |Fenelon        |Victoria         |T. Smithson
  Isle aux Coudres    |               |Saguenay         |
    (sub office.)     |               |                 |
  Isle aux Grues      |               |L’Islet          |P. G. Lachaine dit
                      |               |                 |  Jolicœur
  Isle aux Noix       |               |St. John’s       |
  Isle Perrot         |Isle Perrot    |Vaudreuil        |Marie S. Jobin
  Isle Verte          |Isle Verte     |Temiscouata      |Louis Bertrand
  Islington           |Etobicoke      |York, W. R.      |Thomas Musson
  Ivanhoe             |Huntingdon     |Hastings, N. R.  |Thomas Emo
  Ivy                 |Essa           |Simcoe, S. R.    |T. D. McDonald
                      |               |                 |
                      |               |                 |
  Janetville          |Manvers        |Durham, E. R.    |J. McDermid
  Jarratt’s Corners   |Oro            |Simcoe, N. R.    |Charles Jarratt
  Jarvis              |Walpole        |Haldimand        |James Sill
  Jersey, River       |St. George     |Beauce           |Michael Cahill
    Chaudière         |               |                 |
  Jerseyville         |Ancaster       |Wentworth, S. R. |H. F. Young
  Johnson             |Sydenham       |Grey             |Wm. Johnstone
  Johnson’s Mills     |Hay            |Huron            |Henry Green
  Johnville           |Eaton          |Compton          |Charles Smith
  Jordan              |Louth          |Lincoln          |Jacob Snure
                      |               |                 |
                      |               |                 |
  Kaladar             |Kaladar        |Addington        |E. F. Dunham
  _Kamouraska_        |Kamouraska     |Kamouraska       |Alexis Gagné
  Kars                |N. Gower       |Carleton         |Henry Dunham
  Katesville          |Metcalfe       |Middlesex, W. R. |William McClatchey
  Keenansville        |Adjala         |Simcoe, S. R.    |G. P. Hughes
  _Keene_             |Otanabee       |Peterboro’       |George Read
  Kelvin              |Burford        |Brant, W. R.     |
  _Kemptville_        |Oxford         |Grenville, N. R. |W. H. Bottum
  Kendall             |Clarke         |Durham, W. R.    |W. Trull
  Kenilworth          |Arthur         |Wellington, N. R.|Robert Hayward
  Kenmore             |Osgoode        |Russell          |M. E. Tobin
  Kerrwood            |Adelaide       |Middlesex, W. R. |J. H. Thomas
  Kertch              |Plympton       |Lambton          |James Oxenham
  Keswick             |N. Gwillimbury |York, N. R.      |Henry Stennett
  Kettleby            |King           |York, N. R.      |Jacob Walton
  Kilbride            |Nelson         |Halton           |John Mathews
  Kildare             |Kildare        |Joliette         |O. Vigneault
  Kilkenny            |Kilkenny       |Montcalm         |Marie Julie
                      |               |                 |  Fournier
  Killarney           | North Shore of|Lake Huron       |Solomon Thebo
  Kilmanagh           |Chinguacousy   |Peel             |Isaac Lowes
  Kilmarnock          |Wolford        |Grenville, N. R. |George Newsome
  Kilmartin           |Metcalfe       |Middlesex, W. R. |John Smith
  Kilsyth             |Derby          |Grey             |Thomas Sloan
  Kinburn             |Fitzroy        |Carleton         |R. Power
  _Kincardine_        |Kincardine     |Bruce            |M. McKendrick
  King                |King           |York, N. R.      |Richard Machell
  Kingsey             |Kingsey        |Drummond         |A. Wilcocks
  Kingsey Falls       |Kingsey        |Drummond         |Hayes Gilman
  _Kingston_          |Kingston       |City of Kingston |Robert Deacon
  Kingston Mills      |Kingston       |Frontenac        |Thomas Burrowes
  Kingsville          |Gosfield       |Essex            |John Kennedy
  [4]Kinkora          |Ellice         |Perth            |James Moriarty
  Kinloss             |Kinloss        |Bruce            |Thomas Hodgins
  Kinmount            |Somerville     |Victoria         |John Hunter
  Kinsale             |Pickering      |Ontario, S. R.   |John Fairless
  Kintail             |Ashfield       |Huron            |
  Kintore             |East Nissouri  |Oxford, N. R.    |W. Murray
  Kippen              |Tuckersmith    |Huron            |Robert Bell
  Kirkhill            |Lochiel        |Glengary         |James Dunn
  Kirkton             |Usborne        |Huron            |William Currie
  Kirkwall            |Beverley       |Wentworth, N. R. |W. McMillan
  Klineburgh          |Vaughan        |York, W. R.      |H. S. Howland
  Knowlton            |Brome          |Brome            |Albert Kimball
  Komoka              |Lobo           |Middlesex, W. R. |O. D. Mabee
                      |               |                 |
                      |               |                 |
  La Baie             |La Baie        |Yamaska          |Joseph Rousseau
  Labarre             |Labarre        |Chicoutimi       |C. Hébert
  _La Beauce_         |Ste. Marie     |Beauce           |J. B. Bonneville
  L’Acadie            |L’Acadie       |St. Johns        |Mdme. E. Deneau
  Lachenaie           |Lachenaie      |L’Assomption     |J. O. Laurier
  _Lachine_           |Montreal       |Jacques Cartier  |Fabien Caisse
  _Lachute_           |Argenteuil     |Argenteuil       |John Meikle
  Lac Noir            |Fournier       |L’Islet          |J. B. Pelletier
  _Lacolle_           |Lacolle        |St. John’s       |T. Van Vliet
  Lafontaine          |Tiny           |Simcoe, N. R.    |A. Pilon
  [5]Laggan           |Kenyon         |Glengary         |Donald Cattanach
  La Guerre           |Godmanchester  |Huntingdon       |John McDonald
  Lake Aylmer         |Stratford      |Wolfe            |F. Legendre
  Lake Beauport       |St. Dunstan    |Quebec           |A. Simmons
  Lakefield           |Gore           |Argenteuil       |G. Rogers
  Lakeside            |East Nissouri  |Oxford, N. R.    |H. F. Sharp
  Lake Temiscouata    |               |Temiscouata      |George Dall
  L’Amaroux           |York           |York, W. R.      |James Taylor
  Lambeth             |Westminster    |Middlesex, E. R. |Almond Buck
  Lambton             |Lambton        |Beauce           |Dr. Louis
                      |               |                 |  Labrecque
  _Lanark_            |Lanark         |Lanark, N. R.    |A. G. Hall
  Lancaster           |Lancaster      |Glengary         |K. McPherson
  Langside            |Kinloss        |Bruce            |Peter Reid
  Langton             |Walsingham     |Norfolk          |D. W. Boughner
  Lanoraie            |Lanoraie       |Berthier         |E. Lescault
  Lansdown            |Lansdown       |Leeds, S. R.     |George McKelvey
  L’Anse à Giles      |L’Islet        |L’Islet          |G. F. Giasson
  L’Anse au Foin      |Tremblay       |Chicoutimi       |P. Potvin
  L’Anse St. Jean     |St. Jean       |do.              |L. E. Otis
  La Petite Rivière   |               |Charlevoix       |
    St. François      |               |                 |
    (Sub office)      |               |                 |
  La Pigeonnière      |La Salle       |Napierville      |Moïse Roy
  _Laprairie_         |Laprairie      |Laprairie        |James Charlton
  La Présentation     |La Présentation|St. Hyacinthe    |N. Bergeron
  Largie              |Dunwich        |Elgin, W. R.     |D. McCallum
  Laskay              |King           |York, N. R.      |George S. Baldwin
  L’Assomption        |St. Sulpice    |L’Assomption     |J. Guilbault
  Laterrière          |Notre Dame du  |Chicoutimi       |George McKenzie
                      |  Grand Brûlé  |                 |
  Laurel              |Amaranth       |Wellington, N. R.|James Spence
  Laval               |Laval          |Montmorency      |Rév’d. H. Gagnon
  Lavaltrie           |Lavaltrie      |Berthier         |Joseph Charland
  Lavender            |Mulmur         |Simcoe, S. R.    |I. B. Mastin
  L’Avenir            |Durham         |Drummond         |H. S. Griffing
  Lawrenceville       |South Ely      |Shefford         |F. Lawrence
  Leamington          |Mersea         |Essex            |Warren Kimball
  Leaskdale           |Scott          |Ontario, N. R.   |George Leask
  Leavens             |St. Vincent    |Grey             |S. Cunningham
  _Leeds_             |Leeds          |Megantic         |Matthew Jiggens
  Lefroy              |Innisfil       |Simcoe, S. R.    |David Davidson
  Leinster            |Richmond       |Lenox            |M. Jordan
  Leith               |Sydenham       |Grey             |James Ross, Sr.
  Lemonville          |Whitchurch     |York, N. R.      |John Hill
  _Lennoxville_       |Ascot          |Town of          |J. P. Cushing
                      |               |  Sherbrooke     |
  Lenox               |Fredericksburg |Lenox            |John C. Lucus
  Leonard’s Hill      |Wickham        |Drummond         |M. Leonard
  L’Epiphanie         |St. Sulpice    |L’Assomption     |F. Le Blanc
  Les Eboulemens      |Eboulemens     |Charlevoix       |Edward Slevin
  Les Ecureuils       |D’Auteuil      |Portneuf         |Pierre Pagé
  Les Escoumains      |               |Saguenay         |John C. Barry
  Leskard             |Clarke         |Durham, W. R.    |P. McIntyre
  [6]Leslie           |York           |York, E. R.      |George Leslie, Jr.
  Les Petites         |               |Saguenay         |R. Boulliane
    Bergeronnes       |               |                 |
  [7]Levis            |Lauzon         |Levi             |François Bertrand
  Lifford             |Manvers        |Durham, E. R.    |H. L. Kirby
  Limehouse           |Esquesing      |Halton           |John Newton
  Lime Lake           |Hungerford     |Hastings, N. R.  |James Jarmin
  _Lindsay_           |Ops            |Victoria         |Thomas Adam
  Linton              |King           |York, N. R.      |Joseph Lynn
  Linwood             |Wellesley      |Waterloo, N. R.  |Robert C. Coote
  Lippincott          |York           |York, W. R.      |Mary Larkin
  Lisadel             |Howick         |Huron            |Arthur Mitchell
  Lisbon              |North Easthope |Perth            |John Zinkann
  Lisburn             |Huron          |Bruce            |G. Ruttle
  L’Islet             |L’Islet        |L’Islet          |Mrs. E. Ballantyne
  _Listowell_         |Elma           |Perth            |W. H. Hacking
  Litchfield          |Litchfield     |Pontiac          |Thomas McVeigh
  Little Britain      |Mariposa       |Victoria         |John Broad
  Little Rideau       |Hawkesbury     |Prescott         |Thomas Ross
  _Lloydtown_         |King           |York, N. R.      |Anthony Eastwood
  Lobo                |Lobo           |Middlesex, W. R. |Mrs. E. Fares
  Loch Garry          |Kenyon         |Glengary         |James Fraser
  Lochiel             |Lochiel        |do.              |Owen Quigley
  Lockton             |Albion         |Peel             |Adam Parkinson
  Londesborough       |Hullet         |Huron            |John Neelands
  _London_            |London         |City of London   |Lawrence Lawless
  Long Island Locks   |Nepean         |Carleton         |Moses Gamble
  Long Point          |Island of      |Hochelaga        |J. B. Morin
                      |  Montreal     |                 |
  _Longueuil_         |Longueuil      |Chambly          |P. Lespérance
  Longwood            |Ekfrid         |Middlesex, W. R. |Thomas Gordon
  Lonsdale            |Tyendinaga     |Hastings, S. R.  |Richard Wildman
  Lorette             |Lorette        |Quebec           |J. G. Vincent
  _L’Orignal_         |Longueuil      |Prescott         |C. Johnson
  Lorraine            |Mono           |Simcoe, S. R.    |John Mills
  Lotbinière          |Lotbinière     |Lotbinière       |Joseph Filteau
  Loughboro’          |Loughboro’     |Frontenac        |Hugh Madden
  Low                 |Low            |Ottawa           |Caleb Brooks
  Lower Ireland       |Ireland        |Megantic         |Edward Redman
  Lowville            |Nelson         |Halton           |R. P. Rogers
  Lucan               |Biddulph       |Huron            |William Porte
  Lucknow             |Kinloss        |Bruce            |M. Campbell
  Lunenburg           |Osnabruck      |Stormont         |F. Kirkpatrick
  Lurgan              |Huron          |Bruce            |James McCrindle
  Luther              |Luther         |Wellington, N. R.|Samuel Stuckey
  Luton               |Malahide       |Elgin, E. R.     |L. R. Tyrrell
  _Lyn_               |Elizabethtown  |Town of          |N. Baxter
                      |               |  Brockville     |
  Lynden              |Beverley       |Wentworth, N. R. |William Smith
  Lyndhurst           |Lansdown       |Leeds, S. R.     |William P. Lee
  Lynedoch            |Charlotteville |Norfolk          |George Gray
  Lyons               |South          |Elgin, E. R.     |P. J. Putnam
                      |  Dorchester   |                 |
  Lyster              |Nelson         |Megantic         |John King
                      |               |                 |
                      |               |                 |
  McDonald’s Corners  |Dalhousie      |Lanark, N. R.    |Hugh McLean
  McGillivray         |McGillivray    |Huron            |D. Shoff
  McIntyre            |Osprey         |Grey             |John McLean
  Macnider            |Macnider       |Rimouski         |O. A. Lamontagne
  Macton              |Peel           |Wellington, N. R.|J. M. McCormick
  Macville            |Albion         |Peel             |R. H. Booth
  Maddington          |Maddington     |Arthabaska       |V. St. Germain
  _Madoc_             |Madoc          |Hastings, N. R.  |A. F. Wood
  Magdalen Islands    |               |Gaspé            |J. J. Fox
  Magog               |Magog          |Stanstead        |Calvin Abbott
  Maidstone           |Maidstone      |Essex            |Thomas Moran
  Maitland            |Augusta        |Grenville, S. R. |George C. Longley
  Malakoff            |Marlborough    |Carleton         |W. J. Pierce
  Mallorytown         |Yonge          |Leeds, S. R.     |Frederick F. Lee
  Malta               |Bruce          |Bruce            |Walter Macfarlane
  Malton              |Toronto Gore   |Peel             |J. B. Allen
  Malvern             |Scarboro’      |York, E. R.      |David Brown
  Manchester          |Reach          |Ontario, N. R.   |James Truax
  Mandamin            |Plympton       |Lambton          |James Dunlop
  _Manilla_           |Mariposa       |Victoria         |Mary Douglas
  Manitowaning        |        On Lake|Huron            |George Ironside
  Manningville        |               |Huntingdon       |Fisher Ames
  Mansfield           |Mulmur         |Simcoe, S. R.    |M. Colquhoun
  Maple               |Vaughan        |York, W. R.      |Joseph Noble
  Maple Grove         |Ireland        |Megantic         |Jared B. Hall
  Maple Leaf          |Newport        |Compton          |William G. Planch
  Mapleton            |Yarmouth       |Elgin, E. R.     |Benjamin Wilson
  Mara                |Mara           |Ontario, N. R.   |William Ritchie
  Marbleton           |Dudswell       |Wolfe            |J. B. Bishop
  March               |March          |Carleton         |Thomas Read
  Marchmount          |Orillia        |Simcoe, N. R.    |Francis Kean
  Marden              |Guelph         |Wellington, S. R.|C. McD. Blyth
  Maria               |Maria          |Bonaventure      |
  _Markham_           |Markham        |York, E. R.      |James J. Barker
  Marlbank            |Hungerford     |Hastings, N. R.  |W. G. Allan
  Marlow              |               |Beauce           |James Armstrong
  Marmion             |Sullivan       |Grey             |S. B. Conger
  Marmora             |Marmora        |Hastings, N. R.  |D. G. Bowen
  Marnoch             |Wawanosh       |Huron            |P. Porterfield
  Marshville          |Wainfleet      |Welland          |Edward Lee
  Martintown          |Charlottenburg |Glengary         |Robert Blackwood
  Martinville         |Clifton        |Compton          |Amasa Martin
  Marysville          |Tyendinaga     |Hastings, S. R.  |James Kilmurry
  Mascouche           |Mascouche      |L’Assomption     |M. Delfausse
  Masham              |Masham         |Ottawa           |E. Trempe
  Maskinongé          |Maskinongé     |Maskinongé       |O. Masson
  Massawippi          |West Hatley    |Stanstead        |Luther Abbott
  Matane              |Matane         |Rimouski         |L. N. Blais
  Mawcook             |Granby         |Shefford         |L. N. Hungerford
  Maxwell             |Osprey         |Grey             |Joseph Maxwell
  Mayfield            |Chinguacousy   |Peel             |Wm. Speirs
  Mayne               |Wallace        |Perth            |John Callanan
  Meadowvale          |Toronto        |Peel             |James Gooderham
  Medina              |E. Nissouri    |Oxford, N. R.    |J. H. Beck
  Medonte             |Medonte        |Simcoe, N. R.    |Edmund Moon
  Melancthon          |Melancthon     |Grey             |James Brown
  _Melbourne_         |Melbourne      |Richmond         |Thomas Tait
  Melbourne Ridge     |do.            |do.              |William Beattie
  Melrose             |Tyendinaga     |Hastings, S. R.  |George Duncan
  Melville            |Hillier        |Prince Edward    |
  Menie               |Seymour        |Northumberl’d,   |E. W. Edwards
                      |               |  E. R.          |
  _Merrickville_      |Wolford        |Grenville, N. R. |W. C. Read
  Mersea              |Mersea         |Essex            |Jonathan Wigfield
  Metabechouan        |Metabechouan   |Chicoutimi       |
  Metis               |Metis          |Rimouski         |W. E. Page
  Meyersburg          |Seymour        |Northumberl’d,   |E. R. B. Hayward
                      |               |  E. R.          |
  Middleville         |Lanark         |Lanark, N. R.    |William Croft
  Mile End            |Island of      |Hochelaga        |A. Piché
                      |  Montreal     |                 |
  Milford             |Marysburg      |Prince Edward    |James Cook
  Millbank            |Mornington     |Perth            |W. Rutherford
  Mill Bridge         |Tudor          |Hastings, N. R.  |John Bull
  _Mill Brook_        |Cavan          |Durham, E. R.    |Richard Howden
  Mille Isles         |Mille Isles    |Argenteuil       |John Pollock
  Mille Roches        |Cornwall       |Town of Cornwall |S. H. Moss
  Mille Vaches        |               |Saguenay         |John Peverley
  Mill Grove          |West Flamboro’ |Wentworth, N. R. |James Tyner
  Mill Haven          |Ernestown      |Addington        |George B. Forward
  Milliken            |Markham        |York, E. R.      |W. Gorvett
  Milnesville         |do.            |do.              |Peter Milne
  Milton, East        |Milton         |Shefford         |Charles Gillespie
  _Milton, West_      |Trafalgar      |Halton           |William D. Lyon
  Mimico              |Etobicoke      |York, W. R.      |Herod Noble
  Mimosa              |Erin           |Wellington, S. R.|Henry Reed
  Minden              |Anson          |Victoria         |Daniel Buck
  _Mitchell_          |Logan          |Perth            |John Hicks
  Mohawk              |Brantford, W.  |Brant, W. R.     |William L. Jones
  Moira               |Huntingdon     |Hastings, N. R.  |Henry Ostrom
  Molesworth          |Grey           |Huron            |John Mitchell
  [8]Monckland        |Roxborough     |Stormont         |D. McCallum
  Moneymore           |Hungerford     |Hastings, N. R.  |John Harigan
  Mongenais           |Newton         |Vaudreuil        |H. R. McDonald
  Monkton             |Elma           |Perth            |Edward Greensides
  Mono Centre         |Mono           |Simcoe, S. R.    |Robert Laidlaw
  _Mono Mills_        |do.            |do.              |James McLaughlin
  Montague            |Montague       |Lanark, S. R.    |John Telford
  Montcalm            |Rawdon         |Montcalm         |J. B. LeBlanc
  Monte-Bello         |Petite Nation  |Ottawa           |Charles Major, Jr.
  _Montmagny_         |St. Thomas     |Montmagny        |J. S. Vallée
  _Montreal_          |Montreal       |City of Montreal |E. S. Freer
  Montrose            |Stamford       |Welland          |N. E. Thompson
  Mont St. Hilaire    |St. Hilaire    |Rouville         |J. E. Ducharme
  Moore               |Moore          |Lambton          |Wm. McPherson
  Morewood            |Winchester     |Dundas           |A. McKay
  Morningdale Mills   |Mornington     |Perth            |J. Nicklin
  _Morpeth_           |Howard         |Kent             |Andrew Heyward
  Morrisbank          |Morris         |Huron            |Benjamin Draper
  _Morrisburg_        |Matilda        |Dundas           |James Holden
  Morrisdale          |Grey           |Huron            |Donald Scott
  Morriston           |Puslinch       |Wellington, S. R.|R. B. Morison
  Morton              |S. Crosby      |Leeds, S. R.     |George Morton
  Morven              |Ernestown      |Addington        |Daniel Henwood
  Moscow              |Camden, E.     |do.              |Zarra Vanluven
  Mountain Grove      |Olden          |Frontenac        |E. L. Godfrey
  Mountain View       |Ameliasburgh   |Prince Edward    |W. H. Way
  Mount Albion        |Barton         |Wentworth, S. R. |G. B. Grey
  _Mount Brydges_     |Carradoc       |Middlesex, W. R. |Edward Handy
  Mount Carmel        |Mount Carmel   |Kamouraska       |R. Lavoie
  Mount Charles       |Toronto        |Peel             |Charles King
  Mount Elgin         |Dereham        |Oxford, S. R.    |E. V. Bodwell
  Mount Forest        |Egremont       |Grey             |T. G. Smith
  Mount Healy         |Oneida         |Haldimand        |John Donaldson
  Mount Hurst         |Albion         |Peel             |John Wallace
  Mount Johnson       |Monoir         |Rouville         |John McQuillen
  Mountjoy            |               |Soulanges        |Finlay McQuaig
  Mount Oscar         |Rigaud         |Vaudreuil        |D. McDonell
  Mount Pleasant      |Cavan          |Durham, E. R.    |S. J. Best
  Mountsberg          |E. Flamboro’   |Wentworth, N. R. |M. M. Crooker
  Mount St. Louis     |Medonte        |Simcoe, N. R.    |J. B. Hussey
  Mount St. Patrick   |Brougham       |Renfrew          |Thomas Brady
  Mount Vernon        |Brantford, W.  |Brant, W. R.     |Thomas Perrin
  Mount Webster       |Lansdown       |Leeds, S. R.     |Robert Webster
  Muddy Branch        |Chatham        |Argenteuil       |Fernandez Naubert
  Mulgrave            |Bertie         |Welland          |Joseph J. Zavitz
  Mulmur              |Mulmur         |Simcoe, S. R.    |John Little
  Muncey              |Carradoc       |Middlesex, W. R. |James Musgrove
  Murray              |Murray         |Northumberl’d,   |Richard O. Dickson
                      |               |  E. R.          |
  Murray Bay          |Mountmurray    |Charlevoix       |Edward Tremblay
  Murvale             |Portland       |Frontenac        |Michael Davy
  Muskoka Falls       |Draper         |Victoria         |Richard Hanna
  Musselburg          |Mornington     |Perth            |George Shearer
  Myrtle              |Whitby         |Ontario, S. R.   |Selah Orvis
                      |               |                 |
                      |               |                 |
  Nairn               |Williams       |Middlesex, W. R. |Paul Anstie
  Nanticoke           |Walpole        |Haldimand        |John Mercer
  _Napanee_           |Richmond       |Lenox            |Alexander Campbell
  Napier              |Metcalfe       |Middlesex, W. R. |John Arthurs
  _Napierville_       |De Lery        |Napierville      |N. Palin
  Nashwood            |Farnham        |Brome            |Philip Wood
  Nassagiweya         |Nassagiweya    |Halton           |Thos. Easterbrooke
  Navan               |Cumberland     |Russell          |M. O’Meara
  Nelson              |Nelson         |Halton           |A. G. MacKay
  Netherby            |Humberstone    |Welland          |James Zavitz
  Neustadt            |Normanby       |Grey             |D. Winkler
  New Aberdeen        |Waterloo, S.   |Waterloo, S. R.  |Jos. Thomson
  Newark              |Norwich        |Oxford, S. R.    |Augustus Gary
  Newbliss            |Kitley         |Leeds, N. R.     |John Edgar
  _Newboro’_          |N. Crosby      |Leeds, S. R.     |Thomas Webster
  Newboyne            |Bastard        |do.              |James Lytle
  _Newburgh_          |Camden, East   |Addington        |Robert Hope
  _Newbury_           |Mosa           |Middlesex, W. R. |Thomas Robinson
  New Carlisle        |Cox            |Bonaventure      |Matthew Caldwell
  _New Castle_        |Clarke         |Durham, W. R.    |Hiram Hodges
  New Dundee          |Wilmot         |Waterloo, S. R.  |Peter Ernst
  New Durham          |Burford        |Brant, W. R.     |E. F. Schooley
  New Glasgow         |Lacorne        |Terrebonne       |William Furse
  _New Hamburg_       |Wilmot         |Waterloo, S. R.  |Andrew Ross
  Newington           |Oznabruck      |Stormont         |Jacob Baker
  New Ireland         |Ireland        |Megantic         |Richard C. Porter
  Newland             |E. Gwillimbury |York, N. R.      |R. Hunter
  New Liverpool       |Lauzon         |Levi             |Damase Roberge
  New Lowell          |Sunnidale      |Simcoe, N. R.    |P. Paton
  _New Market_        |Whitchurch     |York, N. R.      |William Roe
  Newport             |Brantford      |Brant, W. R.     |Lyman Chapin
  New Richmond        |New Richmond   |Bonaventure      |Richard Brash
  Newry               |Elma           |Perth            |C. Coulter
  Newtown Robinson    |Tecumseth      |Simcoe, S. R.    |William Chantler
  _Niagara_           |Niagara        |Town of Niagara  |Robert Warren
  _Nicolet_           |Nicolet        |Nicolet          |H. A. Chillas
  Nile                |Colborne       |Huron            |J. Rhynas
  Nilestown           |Dorchester, N. |Middlesex, E. R. |Mary Putnam
  Nissouri            |Nissouri, East |Oxford, N. R.    |Joseph Howes
  Nithburg            |N. Easthope    |Perth            |James Brown
  Nobleton            |King           |York, N. R.      |William Munsie
  Norham              |Percy          |Northumberl’d,   |Dr. B. G. G.
                      |               |  E. R.          |  Demorest
  Norland             |Laxton         |Victoria         |A. A. McLaughlin
  Normandale          |Charlotteville |Norfolk          |John W. Sheppard
  Normanton           |Saugeen        |Bruce            |John J. Lehnen
  North Adjala        |Adjala         |Simcoe, S. R.    |William Donehy
  North Augusta       |Augusta        |Grenville, S. R. |Samuel J. Bellamy
  North Bristol       |Bristol        |Pontiac          |R. Shirley
  North Douro         |Douro          |Peterboro’       |Robert Casement
  North Eldon         |Eldon          |Victoria         |William McCradie
  North Ely           |Ely            |Shefford         |G. Bartlett
  North Georgetown    |Beauharnois    |Chateauguay      |Basile Vannier
  North Glanford      |Glanford       |Wentworth, S. R. |Jacob Terryberry
  North Gower         |N. Gower       |Carleton         |Geo. E. Johnston
  North Lancaster     |Lancaster      |Glengary         |Charles Leclair
  North Mountain      |Mountain       |Dundas           |James Cleland
  North Onslow        |Onslow         |Pontiac          |T. Gibbons
  North Pelham        |Pelham         |Welland          |Mrs. M. A. McQueen
  _North Port_        |Sophiasburg    |Prince Edward    |Samuel Solmes, Jr.
  North Ridge         |Gosfield       |Essex            |W. H. Billing
  North Stanbridge    |Stanbridge     |Missisquoi       |E. B. Stone
  North Stukeley      |Stukeley       |Shefford         |S. Paquette
  North Sutton        |Sutton         |Brome            |S. Sweet
  North Wakefield     |Wakefield      |Ottawa           |A. Pritchard
  North Walsingham    |Walsingham     |Norfolk          |John K. Simons
  North Williamsburg  |Williamsburg   |Dundas           |Wm. Gordon
  Norton Creek        |Beauharnois    |Chateauguay      |Thomas Cantwell
  Norval              |Esquesing      |Halton           |Joseph Kyle
  _Norwich_           |Norwich        |Oxford, S. R.    |Gilbert Moore
  Norwood             |Asphodel       |Peterboro’       |James Foley
  Notfield            |Indian         |Glengary         |Peter Kennedy
                      |  Reservation  |                 |
  Notre-Dame du       |               |Temiscouata      |M. Michaud
    Portage           |               |                 |
  Nottawa             |Nottawasaga    |Simcoe, N. R.    |Andrew Melville
  Noyan               |Sabrevois      |Missisquoi       |T. B. Derick
  Nutt’s Corners      |do.            |do.              |David Nutt
                      |               |                 |
                      |               |                 |
  Oak Hill            |Laxton         |Victoria         |Wm. Corbett
  Oakland             |Oakland        |Brant, W. R.     |John Toyne
  Oak Ridges          |Whitchurch     |York, N. R.      |Frederick Suttle
  _Oakville_          |Trafalgar      |Halton           |R. Balmer
  Oakwood             |Mariposa       |Victoria         |Charles S. Ruttan
  Oban                |Plympton       |Lambton          |William Carrick
  _Odessa_            |Ernestown      |Addington        |P. S. Timmerman
  Oil Springs         |Enniskillen    |Lambton          |William Harrison
  Olinda              |Gosfield       |Essex            |John C. Fox
  Omagh               |Trafalgar      |Halton           |Thomas Little
  Omemee              |Emily          |Victoria         |Robert Grandy
  Oneida              |Oneida         |Haldimand        |J. T. Mutchmore
  Onondaga            |Onondaga       |Brant, W. R.     |William S.
                      |               |                 |  Buckwell
  Onslow              |Onslow         |Pontiac          |Walton Smith
  Ontario             |Saltfleet      |Wentworth, S. R. |John Wilson
  _Orangeville_       |Garafraxa      |Wellington, N. R.|William S. Hewat
  [9]Orchard          |Normanby       |Grey             |Thomas Caldwell
  _Orillia_           |Orillia        |Simcoe, N. R.    |Thomas Moffatt
  Orleans             |North          |Russell          |
                      |  Gloucester   |                 |
  Ormond              |Winchester     |Dundas           |Ira Morgan
  Ormstown            |Beauharnois    |Chateauguay      |R. N. Walsh
  Oro                 |Oro            |Simcoe, N. R.    |Donald Grant
  Orono               |Clarke         |Durham, W. R.    |Joseph L. Tucker
  Orwell              |Yarmouth       |Elgin, E. R.     |D. Sutherland
  Osborne             |Cumberland     |Russell          |G. G. Dunning
  Osceola             |Bromley        |Renfrew          |Alexander McLaren
  Osgoode             |Osgoode        |Russell          |Adam J. Baker
  _Oshawa_            |Whitby         |Ontario, S. R.   |Francis Keller
  Osprey              |Osprey         |Grey             |A. Tupper
  Ospringe            |Erin           |Wellington, S. R.|William Symon
  Ossian              |Enniskillen    |Lambton          |George McPherson
  _Ottawa_            |Nepean         |City of Ottawa   |G. P. Baker
  _Otterville_        |Norwich        |Oxford, S. R.    |John H. Cornell
  Oungah              |Chatham        |Kent             |Stephen Kinny
  Overton             |Camden         |Addington        |Edward Storr
  _Owen Sound_        |Sydenham       |Grey             |George Brown
  Owl’s Head          |Potton         |Brome            |A. C. Jennings
  [10]Oxenden         |Monteagle      |Hastings, N. R.  |Michael Doyle
  Oxford Centre       |Oxford         |Oxford, S. R.    |William Garbutt
  Oxford Mills        |do.            |Grenville, N. R. |Richey Waugh
  Oznabruck Centre    |Oznabruck      |Stormont         |Jacob Poaps
                      |               |                 |
                      |               |                 |
  _Paisley_           |Elderslie      |Bruce            |Thomas Orchard
  _Pakenham_          |Pakenham       |Lanark, N. R.    |William Dickson
  _Palermo_           |Trafalgar      |Halton           |H. M. Switzer
  Panmure             |Fitzroy        |Carleton         |James King
  Papineauville       |Petite Nation  |Ottawa           |Stephen Tucker
  Parham              |Hinchinbrooke  |Frontenac        |T. A. Grant
  _Paris_             |Dumfries, South|Brant, E. R.     |George Stanton
  Paris Station       |do.            |do.              |
  Parma               |Fredericksburg |Lenox            |John C. Green
  Paspebiac           |               |Bonaventure      |D. Bisson
  Pefferlaw           |Georgina       |York, N. R.      |George Johnson
  Pelham Union        |Pelham         |Welland          |
  _Pembroke_          |Pembroke       |Renfrew          |Alexander Moffatt
  Pendleton           |Plantagenet    |Prescott         |J. M. C.
                      |               |                 |  Delesderniers
  _Penetanguishene_   |Tiny           |Simcoe, N. R.    |D. J. Mitchell
  Peninsula-Gaspé     |Gaspé          |Gaspé            |Thomas Cole
  Penville            |Tecumseth      |Simcoe, S. R.    |Edward T. Turner
  Percé               |Percé          |Gaspé            |J. E. Tuzo
  Perrytown           |Hope           |Durham, E. R.    |R. A. Corbett,
                      |               |                 |  M. D.
  _Perth_             |Drummond       |Lanark, S. R.    |William J. Morris
  Petawawa            |Petawawa       |Renfrew          |Charles Young
  _Peterboro’_        |North Monaghan |Peterboro’       |S. J. Carver
  Petersburg          |Wilmot         |Waterloo, S. R.  |John Ernst
  Peterson            |Anson          |Victoria         |
  Peterson’s Ferry    |Sophiasburg    |Prince Edward    |Paul Peterson
  Petrolea            |Enniskillen    |Lambton          |Patrick Barclay
  Petworth            |Portland       |Frontenac        |E. L. Carscallen
  Peveril             |Newton         |Vaudreuil        |Alexander Morrison
  _Philipsburg, East_ |St. Armand     |Missisquoi       |D. T. R. Nye
  Philipsburg, West   |Wilmot         |Waterloo, S. R.  |G. C. Doering
  Philipsville        |Bastard        |Leeds, S. R.     |Sidney A. Taplin
  _Pickering_         |Pickering      |Ontario, S. R.   |Mrs. Elizb’th
                      |               |                 |  Whitney
  _Picton_            |Hallowell      |Prince Edward    |David Barker
  Pierreville         |Pierreville    |Yamaska          |Louis Gill
  Pigeon Hill         |St. Armand     |Missisquoi       |Noah Sager
  _Pike River_        |Stanbridge     |do.              |C. Roberts
  Pine Orchard        |Whitchurch     |York, N. R.      |Cornely Randall
  Pine River          |Huron          |Bruce            |D. McDermid
  Pinkerton           |Greenock       |do.              |M. Pinkerton
  Pittsferry          |Pittsburg      |Frontenac        |Daniel Root
  Plainfield          |Thurlow        |Hastings, S. R.  |H. G. Gillespie
  Plantagenet         |Plantagenet    |Prescott         |Henry Smith
  Plattsville         |Blenheim       |Oxford, N. R.    |Samuel Platt
  Playfair            |Bathurst       |Lanark, S. R.    |S. C. Mills
  Pleasant Hill       |Walsingham     |Norfolk          |J. D. Morgan
  Point Abino         |Bertie         |Welland          |Ralph Disher
  Point Alexander     |Rolph          |Renfrew          |Benjamin McConnell
  Pointe au Chêne     |Grenville      |Argenteuil       |Archibald Cameron
  Pointe aux Anglais  |Two Mountains  |Two Mountains    |Bazile Charlebois
  Pointe aux Trembles |Island of      |Hochelaga        |L. J. O. Lecours
                      |  Montreal     |                 |
  Pointe aux Trembles |Pointe aux     |Portneuf         |Frédéric Larue
                      |  Trembles     |                 |
  Pointe Claire       |Montreal       |Jacques Cartier  |L. B. D’Aoust
  Pointe du Lac       |Pointe du Lac  |St. Maurice      |Louis Comeau
  Point Fortune       |Rigaud         |Vaudreuil        |A. St. Denis
  Point Levi, East    |Lauzon         |Levi             |Charles Bourget
  Point Platon        |St. Croix      |Lotbinière       |Nazaire Noël dit
                      |               |                 |  Tousignant
  Point St. Charles   |Island of      |Jacques Cartier  |E. Blomeley
                      |  Montreal     |                 |
  Point St. Peter     |Malbaie        |Gaspé            |George Packwood
  Poland              |Dalhousie      |Lanark           |W. Rogers
  [11]Ponsonby        |Nichol         |Wellington, N. R.|James Halley
  Pont de Maskinongé  |Maskinongé     |Maskinongé       |A. J. Lafrenière
  Poole               |Mornington     |Perth            |D. Matthews
  _Portage du Fort_   |Litchfield     |Pontiac          |D. F. McLaren
  Port Albert         |Ashfield       |Huron            |Thomas Hawkins
  Port au Persil      |Mount Murray   |Charlevoix       |John McLaren
  Port Bruce          |Malahide       |Elgin, E. R.     |Amasa Lewis
  Port Burwell        |Bayham         |do.              |Thomas Pilcher
  _Port Colborne_     |Humberstone    |Welland          |L. G. Carter
  Port Credit         |Toronto        |Peel             |Robert Cotton
  _Port Dalhousie_    |Grantham       |Lincoln          |John H. Martindale
  Port Daniel         |Port Daniel    |Bonaventure      |Patrick Sweetman
  _Port Dover_        |Woodhouse      |Norfolk          |James Riddell
  Port Elmsley        |North Elmsley  |Lanark, S. R.    |Joseph McCormack
  Port Granby         |Clarke         |Durham           |George Elliott
  Port Hoover         |Cartwright     |do. W. R.        |Thomas Hoover
  _Port Hope_         |Hope           |do. E. R.        |David Smart
  Portland            |Bastard        |Leeds, S. R.     |S. S. Scovil
  Port Lewis          |Godmanchester  |Huntingdon       |B. B. Carson
  Port Maitland       |Sherbrooke     |Haldimand        |James Moss
  Port Nelson         |Nelson         |Halton           |Hugh Cotter
  Portneuf            |Portneuf       |Portneuf         |Charles Gaulin
  Port Perry          |Reach          |Ontario, N. R.   |Joseph Bigelow
  _Port Robinson_     |Thorold        |Welland          |Andrew Murray
  _Port Rowan_        |Walsingham     |Norfolk          |Andrew McLennan
  Port Royal          |do.            |do.              |Mark Barrett
  Port Ryerse         |Woodhouse      |do.              |William H. Ryerse
  Portsmouth          |Kingston       |Frontenac        |George McLeod
  _Port Stanley_      |Yarmouth       |Elgin, E. R.     |
  Port Talbot         |Dunwich        |do. W. R.        |John Clark
  _Prescott_          |Augusta        |Grenville, S. R. |Alpheus Jones
  _Preston_           |Waterloo, South|Waterloo, S. R.  |Conrad Nispel
  Priceville          |Artemesia      |Grey             |John H. Yeomans
  Primrose            |Mono           |Simcoe, S. R.    |John Stewart
  Princeton           |Blenheim       |Oxford, N. R.    |J. G. Lindsay
  Prospect            |Beckwith       |Lanark, S. R.    |John Burrows
  Proton              |Proton         |Grey             |George Armstrong
  Puslinch            |Puslinch       |Wellington       |William Leslie
                      |               |                 |
                      |               |                 |
  _Quebec_            |Quebec         |Quebec           |John Sewell
  Queensborough       |Elzevir        |Hastings, N. R.  |Daniel Thompson
  Queenston           |Niagara        |Lincoln          |James Wynn
  Queensville         |East           |York, N. R.      |James Aylward
                      |  Gwillimbury  |                 |
                      |               |                 |
                      |               |                 |
  Raglan              |Whitby         |Ontario, S. R.   |Loren Foster
  Railton             |Loughboro’     |Frontenac        |John Walsh
  Rainham             |Rainham        |Haldimand        |Charles Williams
  Rainham Centre      |do.            |do.              |Margaret Jones
  Rapides des Joachims|Aberdeen       |Pontiac          |Nichol Mowat
  Ratho               |Blandford      |Oxford, N. R.    |Joseph Williams
  Ravenswood          |Bosanquet      |Lambton          |A. F. Lapham
  Rawdon              |Rawdon         |Montcalm         |Michael Skelly
  Reach               |Reach          |Ontario, N. R.   |M. G. Robson
  Reading             |Garafraxa      |Wellington, N. R.|M. Leeson
  Rednersville        |Ameliasburgh   |Prince Edward    |James Redner
  Reekie              |Kincardine     |Bruce            |Joseph Shier
  _Renfrew_           |Horton         |Renfrew          |George Ross
  Renton              |Townsend       |Norfolk          |James B. Smith
  Repentigny          |L’Assomption   |L’Assomption     |Joseph Etu
  Riceburg            |Stanbridge     |Missisquoi       |C. A. Rice
  Riceville           |Plantagenet    |Prescott         |Peter McLauren
  Richmond, East      |Shipton        |Richmond         |G. K. Foster
  Richmond, West      |Goulburn       |Carleton         |W. H. Butler
  _Richmond Hill_     |Vaughan        |York, W. R.      |Matthew Teefy
  Richview            |Toronto Gore   |Peel             |John Davis
  Richwood            |Blenheim       |Oxford, N. R.    |J. L. Laycock
  Ridgetown           |Howard         |Kent             |T. Rushton
  Rigaud              |Rigaud         |Vaudreuil        |A. W. Charlebois
  _Rimouski_          |Rimouski       |Rimouski         |J. T. Couillard
  Ringwood            |Whitchurch     |York, N. R.      |G. H. Silvester
  Ripley              |Huron          |Bruce            |Thomas Harris
  River Beaudette     |               |Soulanges        |Colin McPherson
  River David         |               |Yamaska          |J. B. Commeault
  River Desert        |               |Ottawa           |John White
  Riversdale          |Greenock       |Bruce            |Thomas Corrigan
  Rivière des Prairies|Montreal       |Hochelaga        |S. Marien, Jr.
  _Rivière du Loup_   |Rivière du Loup|Temiscouata      |Charles H. Gaudry
    (en bas.)_        |               |                 |
  Rivière du Loup     |do.            |Maskinongé       |Louis Baribeau
    (en haut.)_       |               |                 |
  Rivière Ouelle      |Rivière Ouelle |Kamouraska       |Charles H. Têtu,
                      |               |                 |  Sr.
  Rivière Trois       |Trois Pistoles |Temiscouata      |Nazaire Têtu
    Pistoles          |               |                 |
  Roberval            |Roberval       |Chicoutimi       |Rev. C. L. A.
                      |               |                 |  Bernier
  Robinson            |Bury           |Compton          |Lemuel Pope
  Roblin              |Richmond       |Lenox            |William Paul
  Rochelle            |Stukeley       |Shefford         |Louis Dubé
  Rochester           |Rochester      |Essex            |P. Dumouchelle
  Rockford            |Townsend       |Norfolk          |
  Rockland            |Chatham        |Argenteuil       |J. Houston
  Rockport            |Escott         |Leeds, S. R.     |William Cornwall
  Rockton             |Beverley       |Wentworth, N. R. |W. W. Barlow
  Rockwood            |Eramosa        |Wellington, S. R.|Robert Pasmore
  Rodgerville         |Usborne        |Huron            |John Back
  Rokeby              |Sherbrooke     |Lanark, S. R.    |A. Adams
  Rolph               |Middleton      |Norfolk          |E. D. Buchner
  Romney              |Romney         |Kent             |Thomas Renwick
  Rond’eau            |Harwich        |do.              |J. K. Morris
  Rosebank            |Brantford      |Brant, E. R.     |Alex. Robertson
  Rosedene            |Gainsboro’     |Lincoln          |Cornelius McKay
  Rosemont            |Tosorontio     |Simcoe, S. R.    |George Cumming
  Rosetta             |Lanark         |Lanark, N. R.    |
  Roseville           |Dumfries, N.   |Waterloo, S. R.  |John Unger
  Roslin              |Thurlow        |Hastings, S. R.  |William Gilroy
  Ross                |Ross           |Renfrew          |James McLaren
  Rothsay             |Maryboro’      |Wellington, N. R.|James Davidson
  Rouge Hill          |Pickering      |Ontario, S. R.   |M. Brooks
  Rougemont           |St. Césaire    |Rouville         |D. Bachelder
  Round Plains        |Townsend       |Norfolk          |G. A. Averill
  Rowan Mills         |Walsingham     |do.              |Decimus Burrows
  Roxton Falls        |Roxton         |Shefford         |Félix Lauzon
  Rugby               |North Oro      |Simcoe, N. R.    |Walter Hunter
  Ruisseau des Chênes |Upton          |Drummond         |Thos. L.
                      |               |                 |  Desaulniers
  Runnymede           |Restigouche    |Bonaventure      |Henry Lodge
  Russell             |Russell        |Russell          |Richard Helmer
  Russeltown          |               |Chateauguay      |Robert Stewart
  Rutherford          |Dawn           |Lambton          |A. McDonald
  Ruthven             |Gosfield       |Essex            |Hugh Ruthven
  Ryckman’s Corners   |Glanford       |Wentworth, S. R. |G. M. Ryckman
                      |               |                 |
                      |               |                 |
  Ste. Adèle          |Abercrombie    |Terrebonne       |P. A. Labrie
  St. Agatha          |Wilmot         |Waterloo, S. R.  |Anthony Kaiser
  Ste. Agathe         |St. Agathe     |Lotbinière       |L. Boulanger
  St. Agnes           |St. Agnes      |Charlevoix       |Flavien Boily
  St. Aimé            |               |Richelieu        |P. Gélinas
  St. Alban           |Deschambault   |Portneuf         |John D. McCormick
  St. Alexandre       |               |Kamouraska       |Edmond Levêque
  St. Alexandre       |               |Iberville        |A. A. L. Brien
  St. Alexis          |St. Sulpice    |Montcalm         |Léandre LeBau
  St. Alphonse        |               |Joliette         |Luke Corcoran
  St. Anaclet         |St. Anaclet    |Rimouski         |O. Couture
  St. André           |St. André      |Kamouraska       |P. C. Marquis
  St. André Avelin    |Petite Nation  |Ottawa           |Jos. A. Levis
  _St. Andrews, East_ |Argenteuil     |Argenteuil       |T. B. Meikle
  St. Andrews, West   |Cornwall       |Town of Cornwall |Lackey Masterson
  Ste. Angélique      |Petite Nation  |Ottawa           |J. B. N. Papineau
  St. Anicet          |Godmanchester  |Huntingdon       |F. S. Bourgeault
  Ste. Anne, Bout de  |Montreal       |Jacques Cartier  |Thomas Sauvé
    l’Isle            |               |                 |
  Ste. Anne de la     |Ste. Anne      |Champlain        |Thélesphore
    Pérade            |               |                 |  Méthot
  Ste. Anne des Monts |               |Gaspé            |J. Perré
  Ste. Anne des       |Ste. Anne      |Terrebonne       |Hector Granger
    Plaines           |               |                 |
  _Ste. Anne la       |Ste. Anne      |Kamouraska       |Joseph Dionne
    Pocatière_        |               |                 |
  St. Anns, Lincoln   |Gainsboro’     |Lincoln          |Jacob Upper
  St. Anselme         |St. Anselme    |Dorchester       |F. F. Buteau
  St. Antoine,        |St. Antoine    |Lotbinière       |Edmond Larue
    Lotbinière        |               |                 |
  St. Antoine, River  |               |Verchères        |Narcisse Cartier
    Richelieu         |               |                 |
  St. Antonin         |St. Antonin    |Temiscouata      |Rev. G. Talbot
  St. Apollinaire     |Ste. Croix     |Lotbinière       |Remi Martel
  St. Armand Centre   |St. Armand     |Missisquoi       |C. H. Potter
  St. Arsène          |Cacouna        |Temiscouata      |Miss M. Casault
  St. Athanase        |St. Athanase   |Iberville        |P. Regnier
  St. Aubert          |St. Jean, Port |L’Islet          |C. Bourgault
                      |  Joli         |                 |
  St. Augustin,       |               |Portneuf         |C. East
    Portneuf          |               |                 |
  St. Augustin, Two   |               |Two Mountains    |Louis Paquette
    Mountains         |               |                 |
  St. Barnabé, St.    |St. Barnabé    |St. Maurice      |O. Heroux
    Maurice           |               |                 |
  St. Barnabé, River  |do.            |St. Hyacinthe    |Edouard Mathieu
    Yamaska           |               |                 |
  St. Barthélemi      |St. Barthélemi |Berthier         |J. Fauteux
  St. Bazile          |St. Bazile     |Portneuf         |G. Jobin
  St. Benoit          |Two Mountains  |Two Mountains    |Ernest Lemaire
  St. Bernard         |St. Bernard    |Dorchester       |Pierre Plante
  Ste. Brigide        |Monnoir        |Iberville        |William Murray
  St. Bruno           |Montarville    |Chambly          |A. P. Paré
  St. Canute          |St. Canute     |Two Mountains    |John Hanna
  St. Casimir         |St. Casimir    |Portneuf         |Narcisse Paré
  St. Catharines, East|Fossambault    |do.              |Joseph Maloney
  _St. Catharines,    |Grantham       |Lincoln          |J. P. Merritt
    West_             |               |                 |
  St. Celestin        |               |Nicolet          |C. E. Houde
  St. Césaire         |               |Rouville         |C. Dorval
  St. Charles, River  |St. Charles    |St. Hyacinthe    |J. E. LeBlanc
    Richelieu         |               |                 |
  St. Charles, River  |Bellechasse    |Bellechasse      |T. Montminy
    Boyer             |               |                 |
  St. Christophe      |Arthabaska     |Arthabaska       |Noël A. Beaudet
    d’Arthabaska      |               |                 |
  Ste. Claire         |Ste. Claire    |Dorchester       |L. V. Royer
  St. Clements        |Wellesley      |Waterloo, N. R.  |John Stroh
  St. Clet            |Soulanges      |Soulanges        |E. Bourque
  St. Columbin        |               |Two Mountains    |M. J. Phelan
  St. Constant        |Laprairie      |Laprairie        |Pierre Laberge
  Ste. Croix          |Ste. Croix     |Lotbinière       |Moïse Couture
  St. Cuthbert        |               |Berthier         |J. Chenevert
  St. Cyrille         |               |L’Islet          |J. B. Cloutier
  St. Damase          |St. Damase     |St. Hyacinthe    |P. H. Petit
  St. Davids          |Niagara        |Lincoln          |C. Fisher
  St. Denis, River    |St. Denis      |St. Hyacinthe    |Michel Laprise
    Richelieu         |               |                 |
  St. Denis de la     |               |Kamouraska       |J. D. Lavoie
    Bouteillerie      |               |                 |
  St. Didace          |Lanaudière     |Maskinongé       |Elzear Germain
  St. Dominique       |               |Bagot            |Mdme. M. L. Dupont
  St. Dominique des   |Soulanges      |Soulanges        |
    Cèdres            |               |                 |
  St. Edouard         |               |Napierville      |J. Blain
  Ste. Elizabeth      |               |Joliette         |P. L. Hudon dit
                      |               |                 |  Beaulieu
  St. Eloi            |               |Temiscouata      |Charles Thériault
  St. Ephrem d’Upton  |Upton          |Bagot            |S. B. Warner
  St. Esprit          |               |Montcalm         |C. Dalpé dit
                      |               |                 |  Pariseau
  St. Etienne         |St. Maurice    |St. Maurice      |D. Decoteau
  St. Eugène          |East Hawkesbury|Prescott         |A. McBean
  _St. Eustache_      |               |Two Mountains    |David Mitchell
  St. Evariste de     |               |Beauce           |M. Beaudoin
    Forsyth           |               |                 |
  St. Fabien          |               |Rimouski         |Vital Roy dit
                      |               |                 |  Lauzon
  Ste. Famille        |Island of      |Montmorency      |Joseph Prémont
                      |  Orleans      |                 |
  St. Felix de Valoix |               |Joliette         |Max. Crépeau
  St. Féréol          |               |Montmorency      |
    (Sub Office)      |               |                 |
  Ste. Flavie         |               |Rimouski         |J. B. LaMontagne
  St. Flavien         |St. Flavien    |Lotbinière       |L. Bédard
  St. Foy             |Quebec         |Quebec           |Joseph Roy
  St. Francis         |               |Yamaska          |O. H. Coutu
  St. François,       |               |Montmagny        |E. C. Boulet
    Montmagny         |               |                 |
  St. François, Beauce|Beauce         |Beauce           |Hilaire Poulin
  St. François,       |Island of      |Montmorency      |C. E. Dagneault
    d’Orléans         |  Orleans      |                 |  dit Laprise
  St. Frédéric        |St. Frédéric   |Beauce           |P. A. Bélanger
  St. Gabriel de      |Brandon        |Berthier         |M. O’Heir
    Brandon           |               |                 |
  Ste. Geneviève      |Montréal       |Jacques Cartier  |J. M. Paquin
  St. George, Beauce  |St. George     |Beauce           |F. X. Bonhomme
                      |               |                 |  dit Dulac
  _St. George, Brant_ |Dumfries, South|Brant, E. R.     |Samuel Stanton
  St. George de       |Windsor        |Richmond         |Remi Benoit
    Windsor           |               |                 |
  Ste. Gertrude       |Ste. Gertrude  |Nicolet          |Léon Champoux
  St. Gervais         |St. Gervais    |Bellechasse      |Joseph Jolivet
  St. Giles           |St. Giles      |Lotbinière       |George Côté
  St. Grégoire        |St. Grégoire   |Nicolet          |S. Doucet
  St. Guillaume       |Upton          |Yamaska          |Onézime Bellemare
    d’Upton           |               |                 |
  Ste. Helène         |               |Kamouraska       |N. Peltier
  Ste. Helène de Bagot|               |Bagot            |J. T. Poitras
  St. Helens          |Wawanosh       |Huron            |William Gordon
  Ste. Hénédine       |               |Dorchester       |J. Baquet dit La
                      |               |                 |  Montagne
  St. Henri           |Lauzon         |Lévis            |
  St. Hermas          |               |Two Mountains    |P. E. Clairoux
  St. Hilaire Station |St. Hilaire    |Rouville         |Thomas Valiquet
  St. Hilaire Village |do.            |do.              |E. Goulet
  St. Hubert          |               |Chambly          |M. Vincent
  St. Hugues          |               |Bagot            |Hubert Piché
  _St. Hyacinthe_     |St. Hyacinthe  |St. Hyacinthe    |E. L. R. C.
                      |               |                 |  Desprès
  St. Irénée          |               |Charlevoix       |Joseph Gosselin
  St. Isidore,        |               |Dorchester       |B. Morin
    Dorchester        |               |                 |
  St. Isidore,        |               |Laprairie        |F. L. Langevin
    Laprairie         |               |                 |
  St. Ives            |W. Nissouri    |Middlesex, E. R. |Thomas Howard
  St. Jacobs          |Woolwich       |Waterloo, N. R.  |Isaac E. Bowman
  St. Jacques         |St. Sulpice    |L’Assomption     |J. F. Ecrement
  St. Jacques le      |               |Laprairie        |Joseph O. Poirier
    Mineur            |               |                 |
  St. Janvier         |St. Janvier    |Terrebonne       |J. Chartrand
  St. Jean Baptiste   |Rouville       |Rouville         |C. S. Gigon
  St. Jean            |               |Chateauguay      |J. A. Leriche
    Chrysostôme,      |               |                 |
    Chateauguay       |               |                 |
  St. Jean            |Lauzon         |Lévis            |Louis Gosselin
    Chrysostôme,      |               |                 |
    Lévis             |               |                 |
  St. Jean des        |               |Lotbinière       |P. C. Le Vasseur
    Chaillons         |               |                 |
  St. Jean de Matha   |Brandon        |Joliette         |F. X. Lasalle
  St. Jean d’Orléans  |Island of      |Montmorency      |F. X. Turcotte
                      |  Orleans      |                 |
  St. Jean Port Joli  |St. Jean Port  |L’Islet          |Mathilde Fournier
                      |  Joli         |                 |
  St. Jérôme          |               |Terrebonne       |J. B. L. Villemure
  St. Joachim         |St. Joachim    |Montmorency      |Isaïe Simard
  _St. Johns, East_   |               |St. Johns        |W. A. Osgood
  St. Joseph          |St. Joseph     |Beauce           |Joseph O. C.
                      |               |                 |  Arcand
  St. Joseph du Lac   |Two Mountains  |Two Mountains    |John McCoul
  St. Jude            |               |St. Hyacinthe    |J. A. Fournier
  Ste. Julie          |Belœil         |Verchères        |Pierre Chenk
  Ste. Julie de       |Somerset       |Megantic         |Louis Roberge
    Somerset          |               |                 |
  Ste. Julienne       |               |Montcalm         |J. E. Thienel
  St. Justin          |               |Maskinongé       |Louis St. Antoine
  St. Lambert         |Lauzon         |Lévis            |M. Brochu
  St. Lambert,        |Laprairie      |Chambly          |Andrew Irving
    Montréal          |               |                 |
  St. Laurent,        |Island of      |Montmorency      |J. Audet dit
    d’Orléans         |  Orleans      |                 |  Lapointe
  St. Laurent,        |Montreal       |Jacques Cartier  |N. Lecavallier
    Montréal          |               |                 |
  St. Lazare          |               |Bellechasse      |
  St. Léon            |Dumontier      |Maskinongé       |F. X. A. Rivard
  St. Liboire         |St. Liboire    |Bagot            |W. McNichols
  St. Liguori         |               |Montcalm         |J. Octave G.
                      |               |                 |  Belisle
  St. Lin             |               |L’Assomption     |Thomas Garault
  St. Louis de        |               |Beauharnois      |A. H. Leclaire
    Gonzague          |               |                 |
  Ste. Louise         |St. Roch       |L’Islet          |F. Lausier
  St. Luc             |Longueuil      |St. Johns        |Samuel Hamilton
  Ste. Luce           |Lessard        |Rimouski         |James Miller
  St. Marc            |St. Marc       |Verchères        |Z. de St. Aubin
  St. Marcel          |               |Richelieu        |G. Ouellet
  Ste. Marguerite     |               |Dorchester       |Gabriel Ferland
  Ste. Marie de       |Monnoir        |Rouville         |F. H. Gatien
    Monnoir           |               |                 |
  Ste. Marthe         |Rigaud         |Vaudreuil        |E. H. Lalonde
  St. Martin          |Isle Jésus     |Laval            |Charles Smallwood
  Ste. Martine        |Beauharnois    |Chateauguay      |François Gagné
  _St. Mary’s         |Blanshard      |Perth            |Arundel Hill
    Blanshard_        |               |                 |
  St. Mathias         |East Chambly   |Rouville         |Paul Bertrand
  St. Maurice         |               |Champlain        |T. H. Pacaud
  St. Michel          |St. Michel     |Bellechasse      |E. S. Belleau
  St. Modeste         |Wentworth      |Temiscouata      |Narcisse Miville
  Ste. Monique        |Nicolet        |Nicolet          |P. Nourie
  St. Narcisse        |Champlain      |Champlain        |D. Hamelin
  St. Nicholas        |               |Lévis            |Morris Scott
  St. Norbert         |Berthier       |Berthier         |Jules Huguenin
  St. Onézime         |               |Kamouraska       |L. Ouellet
  St. Ours            |St. Ours       |Richelieu        |L. Chapedelaine
  St. Pacôme          |               |Kamouraska       |Alexandre Hudon
  St. Paschal         |Kamouraska     |do.              |A. Blondeau
  St. Patrick’s Hill  |Tingwick       |Arthabaska       |J. P. O’Brien
  St. Paul d’Industrie|               |Joliette         |Pierre Guibord
  St. Paulin          |St. Paulin     |Maskinongé       |P. Desmarais
  St. Paul l’Hermite  |L’Assomption   |L’Assomption     |B. Moreau
  St. Paul’s Bay      |St. Paul’s Bay |Charlevoix       |T. Fortin
  St. Philippe        |               |Laprairie        |E. Roy
  Ste. Philomène      |               |Chateauguay      |J. B. D’Amour
  _St. Pie_           |               |Bagot            |A. Gauthier dit
                      |               |                 |  Landreville
  St. Pierre d’Orléans|Island of      |Montmorency      |F. Fortin
                      |  Orleans      |                 |
  St. Pierre Montmagny|               |Montmagny        |Charles Bacon
  St. Pierre les      |               |Nicolet          |Elie Godin
    Becquets          |               |                 |
  St. Placide         |               |Two Mountains    |Miss E. Joubert
  St. Polycarpe       |New Longueuil  |Soulanges        |John Taylor
  St. Prosper         |               |Champlain        |Philippe Gérard
  St. Raphael, East   |               |Bellechasse      |Narcisse Fortier
  St. Raphael, West   |Charlottenburg |Glengary         |A. McDonell
  St. Raymond         |Bourg Louis    |Portneuf         |Edouard Plamondon
  St. Rémi            |La Salle       |Napierville      |Charles Bédard
  St. Robert          |               |Richelieu        |M. Dumontier
  St. Roch de         |St. Ours       |do.              |P. Kemneur
    Richelieu         |               |                 |
  St. Roch des Aulnets|               |L’Islet          |A. Morin
  St. Roch l’Achigan  |               |L’Assomption     |B. Rocher
  St. Romaine         |Winslow        |Compton          |E. Bellanger
  Ste. Rosalie        |St. Hyacinthe  |Bagot            |P. S. Gendron
  Ste. Rose           |Isle Jésus     |Laval            |J. B. Filiatrault
  St. Sauveur         |Abercrombie    |Terrebonne       |W. H. Scott
  St. Sauveur de      |Banlieue de    |Quebec           |J. L. Saucier
    Québec            |  Québec       |                 |
  Ste. Scholastique   |               |Two Mountains    |A. Fortier
  St. Sévère          |               |St. Maurice      |Adolphe Lemy
  St. Simon de Yamaska|De Ramsay      |Bagot            |Alfred Brien
  St. Simon de        |               |Rimouski         |A. Pelletier
    Rimouski          |               |                 |
  Ste. Sophie         |Halifax        |Megantic         |Olivier Hébert
  Ste. Sophie de      |Lacorne        |Terrebonne       |William Campbell
    Lacorne           |               |                 |
  St. Stanislas       |               |Champlain        |Basilide Roy
  St. Stanislas de    |               |Beauharnois      |Alderic Barbeau
    Kostka            |               |                 |
  St. Sulpice         |L’Assomption   |L’Assomption     |Jacques Royal
  St. Sylvester       |               |Lotbinière       |John Machell
  St. Sylvester East  |               |do.              |George Macrea
  _Ste. Thérèse de    |Blainville     |Terrebonne       |John Morris
    Blainville_       |               |                 |
  St. Thomas, East    |Lanoraie       |Joliette         |Louis Voligny
  _St. Thomas, West_  |Yarmouth       |Elgin, E. R.     |E. Ermatinger
  St. Timothée        |               |Beauharnois      |J. B. Scott
  St. Tite            |               |Champlain        |P. O. Trudel
  St. Urbain          |               |Chateauguay      |Narcisse Dorais
  St. Ursule          |               |Maskinongé       |L. Lupien
  Ste. Valentine      |               |St. Johns        |John Wright
  St. Vallier         |St. Vallier    |Bellechase       |F. Bélanger
  Ste. Victoire       |               |Richelieu        |Dr. Adolphe
                      |               |                 |  Bruneau
  _St. Vincent_       |St. Vincent    |Grey             |D. L. Layton
  St. Vincent de Paul |Isle Jésus     |Laval            |C. Germain, Jr.
  St. Zéphirin        |Courval        |Yamaska          |Thomas N. Hart
  St. Zotique         |               |Soulanges        |O. F. Prieur
                      |               |                 |
                      |               |                 |
  Sable               |West Williams  |Middlesex        |A. McDonald
  Sabrevois           |Sabrevois      |Iberville        |Thomas Jones
  Saintfield          |Reach          |Ontario, N. R.   |Richard Wells
  Salem               |Malahide       |Elgin, E. R.     |George Smades
  Salford             |Dereham        |Oxford, S. R.    |William Boon
  Sandford            |Scott          |Ontario, N. R.   |Edward Taylor
  Sandhill            |Albion         |Peel             |Robert Dwyer, Jr.
  Sand Point          |McNab          |Renfrew          |Alexander McDonell
  _Sandwich_          |Sandwich       |Essex            |P. H. Morin
  Sandy Beach         |South Gaspé Bay|Gaspé            |H. Bailey
  _Sarnia_            |Sarnia         |Lambton          |Alfred Fisher
  _Saugeen_           |Saugeen        |Bruce            |Thomas Lee
  Sault au Recollet   |Montreal       |Hochelaga        |Edouard Dauphin
  Sault Ste. Marie    |    Entrance to|Lake Superior    |David Pim
  Sawyerville         |Newport        |Compton          |William Sawyer
  Scarboro’           |Scarboro’      |York, E. R.      |A. MacLean
  Schomberg           |King           |York, N. R.      |William Moore
  Scone               |Brant          |Bruce            |Thomas Bearman
  Scotch Block        |Esquesing      |Halton           |Thomas Hume
  Scotland            |Oakland        |Brant, W. R.     |H. Lyman
  Scugog              |Scugog         |Ontario, N. R.   |James Gordon
  Seaforth            |Tuckersmith    |Huron            |Archibald Dickson
  Sebringville        |Downie         |Perth            |S. P. Hesson
  Seeley’s Bay        |Leeds          |Leeds, S. R.     |William Coleman
  Selby               |Richmond       |Lenox            |David Wartman
  Selkirk             |Walpole        |Haldimand        |Henry Kent
  Selwyn              |Smith          |Peterboro’       |John Holloway
  _Seneca_            |Seneca         |Haldimand        |John Scott
  Settrington         |Settrington    |Charlevoix       |Charles Chouinard
  Severn Bridge       |Morrison       |Simcoe, N. R.    |James H. Jackson
  _Shakespeare_       |South Easthope |Perth            |Geo. Brown
  Shamrock            |Admaston       |Renfrew          |P. Gorman
  _Shannonville_      |Tyendinaga     |Hastings, S. R.  |Hiram Holden
  Shanty Bay          |Oro            |Simcoe, N. R.    |William Heard
  Shantz              |Waterloo       |Waterloo, N. R.  |A. Mesner
  _Sharon_            |Gwillimbury,   |York, N. R.      |John C. Hogaboom
                      |  East         |                 |
  Shawbridge          |Abercrombie    |Terrebonne       |William Shaw
  Shawenegan          |Shawenegan     |St. Maurice      |Jos. Desaulniers
  Sheffield           |Beverley       |Wentworth, N. R. |Alex. Bell, Sr.
  Shefford Mountain   |Shefford       |Shefford         |D. R. Savage
  _Sherbrooke_        |Ascot          |Town of          |Samuel J. Foss
                      |               |  Sherbrooke     |
  Sheridan            |Toronto        |Peel             |Joshua Pollard
  Sherkston           |Humberstone    |Welland          |Wilson Sherk
  Sherrington         |Sherrington    |Napierville      |George Busby
  Shrewsbury          |Chatham, West  |Argenteuil       |John Chambers
                      |  Gore         |                 |
  Shipley             |Wallace        |Perth            |E. Bristow
  Sillsville          |Fredericksburg |Lenox            |Donovan Sills
  Silver Creek        |Esquesing      |Halton           |John Foreman
  Silver Hill         |Charlotteville |Norfolk          |Elizabeth Cole
  [12]Silvershoe      |Sunnidale      |Simcoe, N. R.    |John Ross
  _Simcoe_            |Woodhouse      |Norfolk          |Henry Mulkins
  Singhampton         |Osprey         |Grey             |J. R. Sing
  Skye                |Kenyon         |Glengary         |J. R. McKenzie
  Sligo               |Caledon        |Peel             |Isaac Hunter
  Smithfield          |Brighton       |Northumberl’d,   |Abijah Smith
                      |               |  E. R.          |
  _Smith’s Falls_     |North Elmsley  |Lanark, S. R.    |James Shaw, Jr.
  _Smithville,        |Grimsby        |Lincoln          |Robert Thompson
    Lincoln_          |               |                 |
  Sombra              |Sombra         |Lambton          |P. Cattanach
  Somerset            |Somerset       |Megantic         |H. Jutras
  Sonya               |Reach          |Ontario, N. R.   |Lewis Harper
  [13]_Sorel_         |Sorel          |Richelieu        |J. O. Duplessis
  South Bolton        |Bolton         |Brome            |John McMannis
  South Cayuga        |South Cayuga   |Haldimand        |Isaac Fry
  South Douro         |Douro          |Peterboro’       |Daniel Sullivan
  South Dummer        |Dummer         |do.              |J. H. Speers
  South Durham        |Durham         |Drummond         |Asa Leighton
  South Elmsley       |South Elmsley  |Leeds, N. R.     |John Ferguson
  South Ely           |Ely            |Shefford         |Amos W. Lay
  South Finch         |Finch          |Stormont         |Nelson Gray
  South Gloucester    |Gloucester     |Russell          |
  South Gower         |South Gower    |Grenville, N. R. |Robert Magee
  South Granby        |Granby         |Shefford         |Elias Clow
  South Hinchinbrooke |Hinchinbrooke  |Huntingdon       |J. Holbrook
  South March         |March          |Carleton         |Samuel Scisson
  South Monaghan      |South Monaghan |Northumberl’d,   |Robert Waddell
                      |               |  W. R.          |
  South Mountain      |Mountain       |Dundas           |John Morrow
  South Potton        |Potton         |Brome            |Alvin Barry
  South Quebec        |Levi           |Levi             |Mrs. Anne Winsley
  South Roxton        |Roxton         |Shefford         |A. Sanborn
  South Zorra         |Zorra          |Oxford, N. R.    |Thomas Cross
  _Sparta_            |Yarmouth       |Elgin, E. R.     |John A. Eakins
  Spencer Cove        |               |Quebec           |Denis Maguire
  Spencerville        |Edwardsburgh   |Grenville, S. R. |W. B. Imrie
  Spring Arbour       |Walsingham     |Norfolk          |J. W. Hazen
  Springford          |Norwich        |Oxford, S. R.    |John Wood
  Springville         |North Monaghan |Peterboro’       |A. Goodfellow
  Staffa              |Hibbert        |Perth            |Thomas Dunn
  Stafford            |Stafford       |Renfrew          |Robert Childerhose
  Stamford            |Stamford       |Welland          |Ellen Wilson
  Stanbridge, East    |Stanbridge     |Missisquoi       |E. J. Briggs
  Standon             |Standon        |Dorchester       |John Nicholson
  Stanfold            |Stanfold       |Arthabaska       |James Huston
  Stanhope            |Barford        |Stanstead        |Alexander Murray
  Stanley’s Mills     |Chinguacousy   |Peel             |T. G. Jackson
  _Stanstead_         |Stanstead      |Stanstead        |B. F. Hubbard
  Starnesboro’        |St. Antoine    |Chateauguay      |Charles McGill
                      |  Abbé         |                 |
  [14]Stayner         |Nottawasaga    |Simcoe, N. R.    |Robert Ross
  Stella              |Amherst Island |Addington        |William Perceval
  Stevensville        |Bertie         |Welland          |Benjamin House
  _Stirling_          |Rawdon         |Hastings, N. R.  |William Judd
  Stoco               |Hungerford     |do.              |Francis Murphy
  Stonefield          |Chatham        |Argenteuil       |Owen Owens
  Stoneham            |               |Quebec           |Nicholas Murphy
  _Stoney Creek_      |Saltfleet      |Wentworth, S. R. |Alva G. Jones
  Stornoway           |Winslow        |Compton          |Colin Noble
  Stottville          |               |St. Johns        |Daniel Stott
  _Stouffville_       |Whitchurch     |York, N. R.      |John White
  _Strabane_          |Flamboro’, West|Wentworth, N. R. |Matthew Peebles
  Straffordville      |Bayham         |Elgin, E. R.     |R. J. McNaughton
  Strangford          |York           |York, E. R.      |Isaac Blain
  _Stratford_         |South Easthope |Perth            |L. T. O’Loane
  Strathburn          |Mosa           |Middlesex, W. R. |Hugh McRae
  [15]Strathglass     |Roxborough     |Stormont         |C. McRea
  _Strathroy_         |Carradoc       |Middlesex, W. R. |Timothy Cook
  _Streetsville_      |Toronto        |Peel             |James E. Rutledge
  Stretton            |Reach          |Ontario, N. R.   |R. Stretton
  Stromness           |Sherbrooke     |Haldimand        |L. McCallum
  Stukeley            |Stukeley       |Shefford         |L. H. Brooks
  Sullivan            |Holland        |Grey             |William Buchanan
  Summerstown         |Charlottenburg |Glengary         |David Summers
  Summerville         |Toronto        |Peel             |William Ward
  Sunnidale           |Sunnidale      |Simcoe, N. R.    |Alexander
                      |               |                 |  Gillespie
  Sutherland’s Corners|Euphemia       |Lambton          |W. Mounteer
  Sutton              |Sutton         |Brome            |G. C. Dyer
  Swainby             |West Williams  |Middlesex, W. R. |James Plewes
  Sweaburg            |West Oxford    |Oxford, S. R.    |James H. Hill
  Sweetsburgh         |Dunham         |Missisquoi       |G. H. Sweet
  Switzerville        |Ernestown      |Addington        |Calvin W. Miller
  Sydenham Place      |Kingsey        |Drummond         |Joseph Millington
  Sylvan              |Williams       |Middlesex, W. R. |Robert Burns
                      |               |                 |
                      |               |                 |
  Tadousac            |               |Saguenay         |Joseph Radford
  Talbotville Royal   |Southwold      |Elgin, W. R.     |John Stacey
  Tamworth            |Sheffield      |Addington        |Robert Herchmer
  Tannery West        |Montreal       |Hochelaga        |A. Desève
  Tapleytown          |Saltfleet      |Wentworth, S. R. |John Springstead
  [16]Tara            |Arran          |Bruce            |D. Sutherland
  Tatlock             |Darling        |Lanark, S. R.    |James Guthrie, Sr.
  Tavistock           |South Easthope |Perth            |L. J. C.
                      |               |                 |  Fredericks
  Tecumseth           |Tecumseth      |Simcoe, S. R.    |Joseph R. Hipwell
  Teeswater           |Culross        |Bruce            |M. Hadwen
  Telfer              |London         |Middlesex, E. R. |Adam Telfer
  Templeton           |Templeton      |Ottawa           |James Hagan
  Teohauta            |Beauharnois    |Beauharnois      |George Ellis
  _Terrebonne_        |Terrebonne     |Terrebonne       |John McKenzie
  Tessierville        |Matane         |Rimouski         |Jean Fournier
  Teviotdale          |Minto          |Wellington, N. R.|William Burns
  Thamesford          |Nissouri, East |Oxford, N. R.    |N. C. McCarty
  Thamesville         |Camden         |Kent             |J. C. Collier
  Thistletown         |Etobicoke      |York, W. R.      |Richard Johnston
  Thomasburg          |Hungerford     |Hastings, N. R.  |W. W. Jones
  Thornbury           |Collingwood    |Grey             |Isaac N. Hurd
  Thorndale           |Nissouri, West |Middlesex, E. R. |Thomas Harrison
  Thorne              |Thorne         |Pontiac          |
  _Thornhill_         |Vaughan        |York, W. R.      |Josiah Purkiss
  Thornton            |Innisfil       |Simcoe, S. R.    |John Henry
  _Thorold_           |Thorold        |Welland          |Jacob Keefer
  Thorold Station     |Grantham       |Lincoln          |S. M. Stephens
  _Three Rivers_      |Three Rivers   |T’n of Three Rivers |C. K. Ogden
  Thurlow             |Thurlow        |Hastings, S. R.  |William T. Casey
  Thurso              |Lochaber       |Ottawa           |G. W. Cameron
  Tilbury, East       |Tilbury, East  |Kent             |James Smith
  Tiverton            |Bruce          |Bruce            |N. McInnes
  Toledo              |Kitley         |Leeds, N. R.     |Alexander McLean
  Topping             |North Easthope |Perth            |S. Crozier
  Tormore             |Albion         |Peel             |William Graham
  _Toronto_           |York           |City of Toronto  |Joseph Lesslie
  Totnes              |Ellice         |Perth            |Mary Coulton
  Tottenham           |Tecumseth      |Simcoe, S. R.    |John Walker
  Townsend Centre     |Townsend       |Norfolk          |Hiram Slaght
  Trafalgar           |Trafalgar      |Halton           |James Appelbe
  Treadwell           |Plantagenet    |Prescott         |P. Georgen
  Trecastle           |Wallace        |Perth            |
  Tremblay            |Tremblay       |Chicoutimi       |Marcel Côté
  Trenholm            |Kingsey        |Drummond         |Simon Stevens
  _Trenton_           |Murray         |Hastings, S. R.  |James Cumming
  Tring               |Tring          |Beauce           |Augustin Bolduc
  Trois Pistoles      |Trois Pistoles |Temiscouata      |T. P. Pelletier
  Trois Saumons       |St. Jean Port  |L’Islet          |G. C. Caron
                      |  Joli         |                 |
  Trout River         |Godmanchester  |Huntingdon       |James Marshall
  Trowbridge          |Elma           |Perth            |G. Code
  Troy                |Beverley       |Wentworth, N. R. |Alexander
                      |               |                 |  McRoberts
  Trudell             |Tilbury, East  |Essex            |S. Aubry
  Tullamore           |Toronto Gore   |Peel             |J. Mulligan
  Tuscarora           |Onondaga       |Brant, E. R.     |W. B. Fyfe
  Tweed               |Hungerford     |Hastings, N. R.  |G. Howell
  Tweedside           |Saltfleet      |Wentworth, S. R. |Gilbert Johnson
  Tyrconnell          |Dunwich        |Elgin, W. R.     |Peter Cameron
  Tyrone              |Darlington     |Durham, W. R.    |John T. Welch
                      |               |                 |
                      |               |                 |
  Udora               |Scott          |Ontario, N. R.   |S. Umphrey
  [17]Ulverton        |Durham         |Drummond         |James Mairs
  Union               |Yarmouth       |Elgin, E. R.     |James Height
  Unionville          |Markham        |York, E. R.      |Andrew Eckardt
  Utica               |Reach          |Ontario, N. R.   |William Adams
  _Uxbridge_          |Uxbridge       |do.              |William Smith
                      |               |                 |
                      |               |                 |
  Valcartier          |Valcartier     |Quebec           |Charles S. Wolff
  Valleyfield         |Beauharnois    |Beauharnois      |John Madden
  _Vankleek Hill_     |Hawkesbury     |Prescott         |Duncan McDonell
  Varennes            |Varennes       |Verchères        |J. N. A.
                      |               |                 |  Archambeault
  Varna               |Stanley        |Huron            |Josiah B. Secord
  Vaudreuil           |Vaudreuil      |Vaudreuil        |F. Desalles
                      |               |                 |  Bastien
  Verchères           |Verchères      |Verchères        |Trefflé Lussier
  Vernon              |Osgoode        |Russell          |J. W. Imlay
  Vernonville         |Haldimand      |Northumberl’d,   |
                      |               |  W. R.          |
  Verona              |Portland       |Frontenac        |A. M. Clark
  Vesta               |Brant and      |Bruce            |Robert Cannon
                      |  Elderslie    |                 |
  Victoria Corners    |Reach          |Ontario, N. R.   |W. H. Stevenson
  Victoria Square     |Markham        |York, E. R.      |Humphrey White
  _Vienna_            |Bayham         |Elgin, E. R.     |John P. Macdonald
  Viger               |Viger          |Temiscouata      |Thomas Tremblay
  Villanova           |Townsend       |Norfolk          |John McLaren
  Violet              |Ernestown      |Addington        |Jacob Lane
  Virgil              |Niagara        |Lincoln          |George Cairns
  _Vittoria_          |Charlotteville |Norfolk          |Simpson McCall
  Vroomanton          |Brock          |Ontario, N. R.   |S. Parrish
                      |               |                 |
                      |               |                 |
  Wakefield           |Wakefield      |Ottawa           |James McLaren
  _Walkerton_         |Brant          |Bruce            |Malcolm McLean
  Wallace             |Wallace        |Perth            |D. M. Williams
  Wallaceburg         |Chatham        |Kent             |Daniel Johnson
  Wallacetown         |Dunwich        |Elgin, W. R.     |John McKillop
  Walsingham          |Walsingham     |Norfolk          |Henry L. Kitchen
  Walter’s Falls      |Holland        |Grey             |John Walter
  Walton              |Grey           |Huron            |George Bigger
  Wanstead            |Plympton       |Lambton          |John Dewar
  Warden              |Shefford       |Shefford         |E. D. Martin
  _Wardsville_        |Mosa           |Middlesex, W. R. |Henry R. Archer
  Warkworth           |Percy          |Northumberl’d,   |Israel Humphries
                      |               |  E. R.          |
  Warrington          |Nottawasaga    |Simcoe, N. R.    |Jesse Peckham
  Warsaw              |Dummer         |Peterboro’       |Thomas Choat
  Warwick, L. C.      |Warwick        |Arthabaska       |L. T. Dorais
  _Warwick, U. C._    |Warwick        |Lambton          |James M. Burns
  Washington          |Blenheim       |Oxford, N. R.    |Daniel Wakefield
  _Waterdown_         |Flamboro’, East|Wentworth, N. R. |James B. Thompson
  _Waterford_         |Townsend       |Norfolk          |James L. Green
  _Waterloo, L. C._   |Shefford       |Shefford         |Jonathan Robinson
  _Waterloo, U. C._   |Waterloo, North|Waterloo, N. R.  |C. Kumpf
  Waterloo, Kingston  |Kingston       |Frontenac        |Joseph Northmore
  Waterville          |Compton        |Compton          |Charles Brooks
  Watford             |Warwick        |Lambton          |James Merry
  Watson’s Corners    |Dalhousie      |Lanark, N. R.    |William Watson
  Waverley            |Flos           |Simcoe, N. R.    |Alexander Kettle
  Weedon              |Weedon         |Wolfe            |Siméon Fontaine
  _Welland_           |Crowland       |Welland          |Thomas Burgar
  Welland Port        |Gainsboro’     |Lincoln          |Samuel Holmes
  _Wellesley_         |Wellesley      |Waterloo, N. R.  |John Zoeger
  Wellington          |Hillier        |Prince Edward    |John D. Selleck
  _Wellington Square_ |Nelson         |Halton           |C. Richardson
  Wellman’s Corners   |Rawdon         |Hastings, N. R.  |Andrew Sherman
  West Arran          |Arran          |Bruce            |John Biggar
  West Brome          |Brome          |Brome            |S. L. Hungerford
  West Brook          |Kingston       |Frontenac        |Benjamin Clark
  West Broughton      |Broughton      |Megantic         |J. St. Hilaire
  Westbury            |Westbury       |Compton          |James Ryther
  West Essa           |Essa           |Simcoe, S. R.    |Thomas Drury
  West Farnham        |Farnham        |Missisquoi       |L. G. Foisy
  Westfield           |Wawanosh       |Huron            |H. Help
  _West Flamboro’_    |Flamboro’      |Wentworth, N. R. |A. Wield
  West Huntingdon     |Huntingdon     |Hastings, N. R.  |J. H. O’Dell
  West Huntley        |Huntley        |Carleton         |Edward Horan
  West McGillivray    |McGillivray    |Huron            |George Stonehouse
  Westmeath           |Westmeath      |Renfrew          |M. M. Drew
  _Weston_            |York           |York, W. R.      |Robert Johnston
  West Osgoode        |Osgoode        |Russell          |John C. Bower
  Westover            |Beverley       |Wentworth, N. R. |W. E. Westover
  Westport            |North Crosby   |Leeds, S. R.     |Walter Whalen
  West’s Corners      |Mornington     |Perth            |John Pierson
  West Shefford       |Shefford       |Shefford         |John N. Mills
  West Winchester     |Winchester     |Dundas           |William Bow
  Westwood            |Asphodel       |Peterboro’       |J. S. Fowlds
  West Woolwich       |Woolwich       |Waterloo, N. R.  |Henry Christman
  Wheatland           |Wickham        |Drummond         |Edward McCabe
  _Whitby_            |Whitby         |Ontario, S. R.   |David Smith
  White Lake          |McNab          |Renfrew          |John Paris
  Whitevale           |Pickering      |Ontario, S. R.   |Thomas Burton
  Whitfield           |Mulmur         |Simcoe, N. R.    |P. D. Henry
  Whittington         |Amaranth       |Wellington, N. R.|R. Bowsfield
  Wick                |Brock          |Ontario, N. R.   |James Brebner
  Wicklow             |Haldimand      |Northumberl’d,   |Andrew McCann
                      |               |  W. R.          |
  Widder              |Bosanquet      |Lambton          |Adam Duffus
  Widder Station      |do.            |do.              |
  Wilkesport          |Sombra         |Lambton          |William Kimball
  _Williams_          |Williams       |Middlesex, W. R. |Colin McKenzie
  Williamstown        |Charlottenburg |Glengary         |Duncan McLennan
  Williscroft         |Elderslie      |Bruce            |George Williscroft
  Willocks            |Verulam        |Victoria         |James Willocks
  Willowdale          |York           |York, W. R.      |Jacob Cummer
  Wilmur              |Loughboro’     |Frontenac        |P. W. Freeman
  Wilton              |Ernestown      |Addington        |Sydney Warner
  Winchester          |Winchester     |Dundas           |C. T. Casselman
  Windham Centre      |Windham        |Norfolk          |James Robertson
  _Windsor_           |Sandwich       |Essex            |Alex. H. Wagner
  Windsor Mills       |Windsor        |Richmond         |C. E. Wurtele
  Winfield            |Peel           |Wellington, N. R.|Ira B. Kilborne
  Wingham             |Turnberry      |Huron            |E. Foley
  Winterbourne        |Woolwich       |Waterloo, N. R.  |Elizabeth Gordon
  Wisbeach            |Warwick        |Lambton          |John Bowes
  Woburn              |Scarboro’      |York, E. R.      |John Irving
  Wolfe Island        |Wolfe Island   |Frontenac        |George Malone
  Wolfstown           |Wolfstown      |Wolfe            |Levi Hodgkinson
  Wolverton           |Blenheim       |Oxford, N. R.    |L. B. Cole
  _Woodbridge_        |Vaughan        |York, W. R.      |John F. Howell
  Woodburn            |Binbrook       |Wentworth, S. R. |William Ptolemy
  Woodford            |Sydenham       |Grey             |Robert Lemon
  Woodside            |Halifax        |Megantic         |Thomas Wood
  Woodslee            |Maidstone      |Essex            |W. S. Lindsay
  _Woodstock_         |Blandford      |Oxford, N. R.    |Chas. DeBlaquière
  Woodville           |Eldon          |Victoria         |John Morrison
  Wooler              |Murray         |Northumberl’d,   |Reuben Scott
                      |               |  E. R.          |
  Wotton              |Wotton         |Wolfe            |C. Ducharme
  Wright              |Wright         |Ottawa           |J. G. Williams
  _Wroxeter_          |Howick         |Huron            |A. G. Berney
  Wyebridge           |Tiny           |Simcoe, N. R.    |James Plewes
  _Wyoming_           |Plympton       |Lambton          |George Brown
                      |               |                 |
                      |               |                 |
  Yamachiche          |Machiche       |St. Maurice      |Elie Lacerte
  Yamaska             |Yamaska        |Yamaska          |E. G. Dugré
  Yarker              |Camden         |Addington        |J. A. Shibley
  _York_              |Seneca         |Haldimand        |Charles L. Hudson
  York Mills          |York           |York, E. R.      |John Hogg
  York River          |Faraday        |Hastings, N. R.  |James Cleak
  Yorkville           |York           |York, E. R.      |James Dobson
                      |               |                 |
                      |               |                 |
  Zetland             |Turnberry      |Huron            |John W. Bowman
  Zimmerman           |Nelson         |Halton           |H. P. Zimmerman
  Zurich              |Hay            |Huron            |Frederick Knell
  --------------------+---------------+-----------------+-----------------

[1] Late Walmer.

[2] Closed during winter.

[3] Late Taunton.

[4] Re-opened.

[5] Late Kenyon.

[6] Late Ashport.

[7] Late Point Levi.

[8] Late Roxborough.

[9] Late Normanby.

[10] Late Tara.

[11] Late Thorpville.

[12] Late Sunnidale Station.

[13] Late William Henry.

[14] Late Nottawasaga Station.

[15] Late Roxborough West.

[16] Late Eblana.

[17] Late Durham.




List of Post Offices closed between 1st January, 1862, and 1st January,
1863, inclusive.


  =====================+============+=======================
  NAME OF POST OFFICE. |COUNTY.     |REMARKS.
  ---------------------+------------+-----------------------
  Brooke               |Lambton     |
  Buncrana             |Brant       |
  Dorking              |Wellington  |
  Dougherty            |Perth       |
  Elbe                 |Leeds       |
  Fairview             |Oxford      |
  Fermanagh            |Durham      |
  Girvan               |Russell     |
  Keith                |Lambton     |
  Le Foulon            |Prescott    |
  Lesieur              |St. Maurice |
  Martin’s Corners     |Beauharnois |
  Shafton              |Pontiac     |
  Sweaburg             |Oxford      |Re-opened 1st June 1862
  Warner               |Lincoln     |
  ---------------------+------------+-----------------------




List of Changes in the names of Post Offices, between 1st January, 1862,
and 1st January, 1863.


  =====================+============+=====================
  LATE NAME OF OFFICE. |COUNTY.     |NEW NAME SELECTED.
  ---------------------+------------+---------------------
  Ashport              |York        |Leslie
  Durham               |Drummond    |Ulverton
  Eblana               |Bruce       |Tara
  Kenyon               |Glengary    |Laggan
  Lattas Mills         |Hastings    |Plainfield
  Maskinongé           |Maskinongé  |Pont de Maskinongé
  Normanby             |Grey        |Orchard
  Nottawasaga Station  |Simcoe      |Stayner
  Point Levi           |Levi        |Levis
  Roxborough           |Stormont    |Monckland
  Roxborough West      |do.         |Strathglass
  Sunnidale Station    |Simcoe      |Silvershoe
  Tara                 |Hastings    |Oxenden
  Taunton              |Huron       |Farquhar
  Upton                |Yamaska     |St. Guillaume d’Upton
  Weimar               |Waterloo    |Bamberg
  William Henry        |Richelieu   |Sorel
                       |            |
  [18]Thorpville       |Wellington  |Ponsonby
  [18]Walmer           |do.         |Bosworth
  ---------------------+------------+---------------------

[18] Names to be changed as above, on 1st February, 1863.

*** END OF THE PROJECT GUTENBERG EBOOK LIST OF POST OFFICES IN CANADA,
WITH THE NAMES OF THE POSTMASTERS ON THE 1ST JANUARY, 1863 ***

Updated editions will replace the previous one--the old editions will
be renamed.

Creating the works from print editions not protected by U.S. copyright
law means that no one owns a United States copyright in these works,
so the Foundation (and you!) can copy and distribute it in the
United States without permission and without paying copyright
royalties. Special rules, set forth in the General Terms of Use part
of this license, apply to copying and distributing Project
Gutenberg-tm electronic works to protect the PROJECT GUTENBERG-tm
concept and trademark. Project Gutenberg is a registered trademark,
and may not be used if you charge for an eBook, except by following
the terms of the trademark license, including paying royalties for use
of the Project Gutenberg trademark. If you do not charge anything for
copies of this eBook, complying with the trademark license is very
easy. You may use this eBook for nearly any purpose such as creation
of derivative works, reports, performances and research. Project
Gutenberg eBooks may be modified and printed and given away--you may
do practically ANYTHING in the United States with eBooks not protected
by U.S. copyright law. Redistribution is subject to the trademark
license, especially commercial redistribution.

START: FULL LICENSE

THE FULL PROJECT GUTENBERG LICENSE
PLEASE READ THIS BEFORE YOU DISTRIBUTE OR USE THIS WORK

To protect the Project Gutenberg-tm mission of promoting the free
distribution of electronic works, by using or distributing this work
(or any other work associated in any way with the phrase "Project
Gutenberg"), you agree to comply with all the terms of the Full
Project Gutenberg-tm License available with this file or online at
www.gutenberg.org/license.

Section 1. General Terms of Use and Redistributing Project
Gutenberg-tm electronic works

1.A. By reading or using any part of this Project Gutenberg-tm
electronic work, you indicate that you have read, understand, agree to
and accept all the terms of this license and intellectual property
(trademark/copyright) agreement. If you do not agree to abide by all
the terms of this agreement, you must cease using and return or
destroy all copies of Project Gutenberg-tm electronic works in your
possession. If you paid a fee for obtaining a copy of or access to a
Project Gutenberg-tm electronic work and you do not agree to be bound
by the terms of this agreement, you may obtain a refund from the
person or entity to whom you paid the fee as set forth in paragraph
1.E.8.

1.B. "Project Gutenberg" is a registered trademark. It may only be
used on or associated in any way with an electronic work by people who
agree to be bound by the terms of this agreement. There are a few
things that you can do with most Project Gutenberg-tm electronic works
even without complying with the full terms of this agreement. See
paragraph 1.C below. There are a lot of things you can do with Project
Gutenberg-tm electronic works if you follow the terms of this
agreement and help preserve free future access to Project Gutenberg-tm
electronic works. See paragraph 1.E below.

1.C. The Project Gutenberg Literary Archive Foundation ("the
Foundation" or PGLAF), owns a compilation copyright in the collection
of Project Gutenberg-tm electronic works. Nearly all the individual
works in the collection are in the public domain in the United
States. If an individual work is unprotected by copyright law in the
United States and you are located in the United States, we do not
claim a right to prevent you from copying, distributing, performing,
displaying or creating derivative works based on the work as long as
all references to Project Gutenberg are removed. Of course, we hope
that you will support the Project Gutenberg-tm mission of promoting
free access to electronic works by freely sharing Project Gutenberg-tm
works in compliance with the terms of this agreement for keeping the
Project Gutenberg-tm name associated with the work. You can easily
comply with the terms of this agreement by keeping this work in the
same format with its attached full Project Gutenberg-tm License when
you share it without charge with others.

1.D. The copyright laws of the place where you are located also govern
what you can do with this work. Copyright laws in most countries are
in a constant state of change. If you are outside the United States,
check the laws of your country in addition to the terms of this
agreement before downloading, copying, displaying, performing,
distributing or creating derivative works based on this work or any
other Project Gutenberg-tm work. The Foundation makes no
representations concerning the copyright status of any work in any
country other than the United States.

1.E. Unless you have removed all references to Project Gutenberg:

1.E.1. The following sentence, with active links to, or other
immediate access to, the full Project Gutenberg-tm License must appear
prominently whenever any copy of a Project Gutenberg-tm work (any work
on which the phrase "Project Gutenberg" appears, or with which the
phrase "Project Gutenberg" is associated) is accessed, displayed,
performed, viewed, copied or distributed:

  This eBook is for the use of anyone anywhere in the United States and
  most other parts of the world at no cost and with almost no
  restrictions whatsoever. You may copy it, give it away or re-use it
  under the terms of the Project Gutenberg License included with this
  eBook or online at www.gutenberg.org. If you are not located in the
  United States, you will have to check the laws of the country where
  you are located before using this eBook.

1.E.2. If an individual Project Gutenberg-tm electronic work is
derived from texts not protected by U.S. copyright law (does not
contain a notice indicating that it is posted with permission of the
copyright holder), the work can be copied and distributed to anyone in
the United States without paying any fees or charges. If you are
redistributing or providing access to a work with the phrase "Project
Gutenberg" associated with or appearing on the work, you must comply
either with the requirements of paragraphs 1.E.1 through 1.E.7 or
obtain permission for the use of the work and the Project Gutenberg-tm
trademark as set forth in paragraphs 1.E.8 or 1.E.9.

1.E.3. If an individual Project Gutenberg-tm electronic work is posted
with the permission of the copyright holder, your use and distribution
must comply with both paragraphs 1.E.1 through 1.E.7 and any
additional terms imposed by the copyright holder. Additional terms
will be linked to the Project Gutenberg-tm License for all works
posted with the permission of the copyright holder found at the
beginning of this work.

1.E.4. Do not unlink or detach or remove the full Project Gutenberg-tm
License terms from this work, or any files containing a part of this
work or any other work associated with Project Gutenberg-tm.

1.E.5. Do not copy, display, perform, distribute or redistribute this
electronic work, or any part of this electronic work, without
prominently displaying the sentence set forth in paragraph 1.E.1 with
active links or immediate access to the full terms of the Project
Gutenberg-tm License.

1.E.6. You may convert to and distribute this work in any binary,
compressed, marked up, nonproprietary or proprietary form, including
any word processing or hypertext form. However, if you provide access
to or distribute copies of a Project Gutenberg-tm work in a format
other than "Plain Vanilla ASCII" or other format used in the official
version posted on the official Project Gutenberg-tm website
(www.gutenberg.org), you must, at no additional cost, fee or expense
to the user, provide a copy, a means of exporting a copy, or a means
of obtaining a copy upon request, of the work in its original "Plain
Vanilla ASCII" or other form. Any alternate format must include the
full Project Gutenberg-tm License as specified in paragraph 1.E.1.

1.E.7. Do not charge a fee for access to, viewing, displaying,
performing, copying or distributing any Project Gutenberg-tm works
unless you comply with paragraph 1.E.8 or 1.E.9.

1.E.8. You may charge a reasonable fee for copies of or providing
access to or distributing Project Gutenberg-tm electronic works
provided that:

* You pay a royalty fee of 20% of the gross profits you derive from
  the use of Project Gutenberg-tm works calculated using the method
  you already use to calculate your applicable taxes. The fee is owed
  to the owner of the Project Gutenberg-tm trademark, but he has
  agreed to donate royalties under this paragraph to the Project
  Gutenberg Literary Archive Foundation. Royalty payments must be paid
  within 60 days following each date on which you prepare (or are
  legally required to prepare) your periodic tax returns. Royalty
  payments should be clearly marked as such and sent to the Project
  Gutenberg Literary Archive Foundation at the address specified in
  Section 4, "Information about donations to the Project Gutenberg
  Literary Archive Foundation."

* You provide a full refund of any money paid by a user who notifies
  you in writing (or by e-mail) within 30 days of receipt that s/he
  does not agree to the terms of the full Project Gutenberg-tm
  License. You must require such a user to return or destroy all
  copies of the works possessed in a physical medium and discontinue
  all use of and all access to other copies of Project Gutenberg-tm
  works.

* You provide, in accordance with paragraph 1.F.3, a full refund of
  any money paid for a work or a replacement copy, if a defect in the
  electronic work is discovered and reported to you within 90 days of
  receipt of the work.

* You comply with all other terms of this agreement for free
  distribution of Project Gutenberg-tm works.

1.E.9. If you wish to charge a fee or distribute a Project
Gutenberg-tm electronic work or group of works on different terms than
are set forth in this agreement, you must obtain permission in writing
from the Project Gutenberg Literary Archive Foundation, the manager of
the Project Gutenberg-tm trademark. Contact the Foundation as set
forth in Section 3 below.

1.F.

1.F.1. Project Gutenberg volunteers and employees expend considerable
effort to identify, do copyright research on, transcribe and proofread
works not protected by U.S. copyright law in creating the Project
Gutenberg-tm collection. Despite these efforts, Project Gutenberg-tm
electronic works, and the medium on which they may be stored, may
contain "Defects," such as, but not limited to, incomplete, inaccurate
or corrupt data, transcription errors, a copyright or other
intellectual property infringement, a defective or damaged disk or
other medium, a computer virus, or computer codes that damage or
cannot be read by your equipment.

1.F.2. LIMITED WARRANTY, DISCLAIMER OF DAMAGES - Except for the "Right
of Replacement or Refund" described in paragraph 1.F.3, the Project
Gutenberg Literary Archive Foundation, the owner of the Project
Gutenberg-tm trademark, and any other party distributing a Project
Gutenberg-tm electronic work under this agreement, disclaim all
liability to you for damages, costs and expenses, including legal
fees. YOU AGREE THAT YOU HAVE NO REMEDIES FOR NEGLIGENCE, STRICT
LIABILITY, BREACH OF WARRANTY OR BREACH OF CONTRACT EXCEPT THOSE
PROVIDED IN PARAGRAPH 1.F.3. YOU AGREE THAT THE FOUNDATION, THE
TRADEMARK OWNER, AND ANY DISTRIBUTOR UNDER THIS AGREEMENT WILL NOT BE
LIABLE TO YOU FOR ACTUAL, DIRECT, INDIRECT, CONSEQUENTIAL, PUNITIVE OR
INCIDENTAL DAMAGES EVEN IF YOU GIVE NOTICE OF THE POSSIBILITY OF SUCH
DAMAGE.

1.F.3. LIMITED RIGHT OF REPLACEMENT OR REFUND - If you discover a
defect in this electronic work within 90 days of receiving it, you can
receive a refund of the money (if any) you paid for it by sending a
written explanation to the person you received the work from. If you
received the work on a physical medium, you must return the medium
with your written explanation. The person or entity that provided you
with the defective work may elect to provide a replacement copy in
lieu of a refund. If you received the work electronically, the person
or entity providing it to you may choose to give you a second
opportunity to receive the work electronically in lieu of a refund. If
the second copy is also defective, you may demand a refund in writing
without further opportunities to fix the problem.

1.F.4. Except for the limited right of replacement or refund set forth
in paragraph 1.F.3, this work is provided to you 'AS-IS', WITH NO
OTHER WARRANTIES OF ANY KIND, EXPRESS OR IMPLIED, INCLUDING BUT NOT
LIMITED TO WARRANTIES OF MERCHANTABILITY OR FITNESS FOR ANY PURPOSE.

1.F.5. Some states do not allow disclaimers of certain implied
warranties or the exclusion or limitation of certain types of
damages. If any disclaimer or limitation set forth in this agreement
violates the law of the state applicable to this agreement, the
agreement shall be interpreted to make the maximum disclaimer or
limitation permitted by the applicable state law. The invalidity or
unenforceability of any provision of this agreement shall not void the
remaining provisions.

1.F.6. INDEMNITY - You agree to indemnify and hold the Foundation, the
trademark owner, any agent or employee of the Foundation, anyone
providing copies of Project Gutenberg-tm electronic works in
accordance with this agreement, and any volunteers associated with the
production, promotion and distribution of Project Gutenberg-tm
electronic works, harmless from all liability, costs and expenses,
including legal fees, that arise directly or indirectly from any of
the following which you do or cause to occur: (a) distribution of this
or any Project Gutenberg-tm work, (b) alteration, modification, or
additions or deletions to any Project Gutenberg-tm work, and (c) any
Defect you cause.

Section 2. Information about the Mission of Project Gutenberg-tm

Project Gutenberg-tm is synonymous with the free distribution of
electronic works in formats readable by the widest variety of
computers including obsolete, old, middle-aged and new computers. It
exists because of the efforts of hundreds of volunteers and donations
from people in all walks of life.

Volunteers and financial support to provide volunteers with the
assistance they need are critical to reaching Project Gutenberg-tm's
goals and ensuring that the Project Gutenberg-tm collection will
remain freely available for generations to come. In 2001, the Project
Gutenberg Literary Archive Foundation was created to provide a secure
and permanent future for Project Gutenberg-tm and future
generations. To learn more about the Project Gutenberg Literary
Archive Foundation and how your efforts and donations can help, see
Sections 3 and 4 and the Foundation information page at
www.gutenberg.org

Section 3. Information about the Project Gutenberg Literary
Archive Foundation

The Project Gutenberg Literary Archive Foundation is a non-profit
501(c)(3) educational corporation organized under the laws of the
state of Mississippi and granted tax exempt status by the Internal
Revenue Service. The Foundation's EIN or federal tax identification
number is 64-6221541. Contributions to the Project Gutenberg Literary
Archive Foundation are tax deductible to the full extent permitted by
U.S. federal laws and your state's laws.

The Foundation's business office is located at 809 North 1500 West,
Salt Lake City, UT 84116, (801) 596-1887. Email contact links and up
to date contact information can be found at the Foundation's website
and official page at www.gutenberg.org/contact

Section 4. Information about Donations to the Project Gutenberg
Literary Archive Foundation

Project Gutenberg-tm depends upon and cannot survive without
widespread public support and donations to carry out its mission of
increasing the number of public domain and licensed works that can be
freely distributed in machine-readable form accessible by the widest
array of equipment including outdated equipment. Many small donations
($1 to $5,000) are particularly important to maintaining tax exempt
status with the IRS.

The Foundation is committed to complying with the laws regulating
charities and charitable donations in all 50 states of the United
States. Compliance requirements are not uniform and it takes a
considerable effort, much paperwork and many fees to meet and keep up
with these requirements. We do not solicit donations in locations
where we have not received written confirmation of compliance. To SEND
DONATIONS or determine the status of compliance for any particular
state visit www.gutenberg.org/donate

While we cannot and do not solicit contributions from states where we
have not met the solicitation requirements, we know of no prohibition
against accepting unsolicited donations from donors in such states who
approach us with offers to donate.

International donations are gratefully accepted, but we cannot make
any statements concerning tax treatment of donations received from
outside the United States. U.S. laws alone swamp our small staff.

Please check the Project Gutenberg web pages for current donation
methods and addresses. Donations are accepted in a number of other
ways including checks, online payments and credit card donations. To
donate, please visit: www.gutenberg.org/donate

Section 5. General Information About Project Gutenberg-tm electronic works

Professor Michael S. Hart was the originator of the Project
Gutenberg-tm concept of a library of electronic works that could be
freely shared with anyone. For forty years, he produced and
distributed Project Gutenberg-tm eBooks with only a loose network of
volunteer support.

Project Gutenberg-tm eBooks are often created from several printed
editions, all of which are confirmed as not protected by copyright in
the U.S. unless a copyright notice is included. Thus, we do not
necessarily keep eBooks in compliance with any particular paper
edition.

Most people start at our website which has the main PG search
facility: www.gutenberg.org

This website includes information about Project Gutenberg-tm,
including how to make donations to the Project Gutenberg Literary
Archive Foundation, how to help produce our new eBooks, and how to
subscribe to our email newsletter to hear about new eBooks.
